5 5 5 5 5 5 5 5 5 5 5 5 5 5 5 5 5 5 14 14 14 14 14 14 14 14 14 14 14 14 14 14 5 5 5 5 5 5 5 5 5 5 14 14 14 14 14 14 14 5
5 5 5 5 5 5 5 5 5 5 5 5 5 5 5 5 5 12 20 35 35 35 35 35 35 35 35 35 35 35 35 21 13 5 5 5 5 5 5 5 5 12 20 35 35 35 132 19 45 13
5 5 5 5 5 5 5 5 5 5 5 5 5 5 5 5 5 12 34 128 37 37 37 37 37 37 37 37 37 37 129 36 13 5 5 5 5 5 5 5 5 12 34 1 1 1 36 8 18 13
5 5 5 5 5 5 5 5 5 5 5 5 5 5 5 5 5 12 34 36 10 11 31 31 31 31 31 31 11 15 34 36 13 5 5 5 5 5 5 5 5 12 34 1 1 1 127 35 137 13
5 5 5 5 5 5 5 5 5 14 14 14 14 14 14 14 14 16 34 36 13 12 20 35 35 35 35 21 13 12 34 36 17 14 14 14 14 14 14 14 14 16 34 1 1 1 1 1 36 13
5 5 5 5 5 5 5 5 12 20 35 35 35 35 35 35 35 35 130 36 13 12 34 1 1 1 1 36 13 12 34 127 35 35 35 35 35 35 35 132 19 19 142 1 1 1 1 1 36 13
5 5 5 5 5 5 5 5 12 34 1 1 1 1 1 1 1 1 1 36 13 12 34 1 1 1 1 36 13 12 34 1 1 1 1 1 1 1 1 36 10 15 34 1 1 1 1 1 36 13
5 5 5 5 14 14 14 14 16 34 1 1 1 1 1 1 1 1 1 36 13 12 34 1 1 1 1 36 13 12 34 1 1 1 1 1 1 1 1 36 13 12 23 37 37 37 37 37 22 13
5 5 5 12 20 35 35 35 35 130 1 1 1 1 1 1 1 1 1 36 13 12 34 1 1 1 1 36 13 12 34 1 1 1 1 1 1 1 1 36 17 14 31 31 31 31 5 11 11 5
5 5 5 12 34 128 37 37 37 37 37 37 37 37 37 37 37 37 37 22 13 12 34 1 1 1 1 36 13 12 23 37 37 37 37 37 37 37 37 138 19 19 19 19 136 21 13 5 5 5
5 5 5 12 34 36 10 11 11 11 11 11 11 11 11 11 11 11 11 11 5 12 34 1 1 1 1 36 13 5 11 11 11 11 11 11 11 11 11 11 11 11 11 15 34 36 13 5 5 5
5 5 5 12 34 36 13 5 14 14 14 14 14 14 14 14 14 14 14 14 14 16 34 1 1 1 1 36 17 14 14 14 14 14 14 14 14 14 14 14 14 14 5 12 34 36 13 5 5 5
5 5 5 12 34 36 13 12 20 35 35 35 35 35 35 35 35 35 35 35 35 35 130 1 1 1 1 127 35 35 35 35 35 35 35 35 35 35 35 35 35 21 13 12 34 36 13 5 5 5
5 5 5 12 34 36 13 12 34 1 1 1 1 1 1 1 1 1 1 1 1 1 1 1 1 1 1 1 1 1 1 1 1 1 1 1 1 1 1 1 1 36 13 12 34 36 13 5 5 5
5 5 5 12 34 36 13 12 34 1 1 1 1 1 1 1 1 1 1 1 1 1 1 1 1 1 1 1 1 1 1 1 1 1 1 1 1 1 1 1 1 36 13 12 34 36 13 5 5 5
5 5 5 12 34 36 13 12 34 1 1 1 1 1 1 1 1 1 1 1 1 1 1 1 1 1 1 1 1 1 1 1 1 1 1 1 1 1 1 1 1 36 13 12 34 36 13 5 5 5
5 5 5 12 34 36 13 12 34 1 1 1 1 1 1 1 1 1 1 1 1 1 1 1 1 1 1 1 1 1 1 1 1 1 1 1 1 1 1 1 1 36 13 12 34 36 13 5 5 5
5 5 5 12 34 36 13 12 23 37 37 37 37 37 37 37 37 37 37 37 37 37 129 1 1 1 1 128 37 37 37 37 37 37 37 37 37 37 37 37 37 22 13 12 34 36 13 5 5 5
5 5 5 12 34 36 13 27 11 11 11 11 11 11 11 11 11 11 11 11 11 15 34 1 1 1 1 36 10 11 11 11 11 11 11 11 11 11 11 11 11 11 5 12 34 36 13 5 5 5
5 5 5 12 34 36 17 14 14 14 14 14 14 14 14 14 14 14 14 14 5 12 34 1 1 1 1 36 13 5 14 14 14 14 14 14 14 14 14 14 14 14 14 16 34 36 13 5 5 5
5 5 5 12 34 127 35 35 35 35 35 35 35 35 35 35 35 35 35 21 13 12 34 1 1 1 1 36 13 12 44 19 19 19 19 136 35 35 35 35 35 35 35 35 130 36 13 5 5 5
5 5 5 12 23 37 37 37 37 129 1 1 1 1 1 1 1 1 1 36 13 12 34 1 1 1 1 36 13 12 18 10 31 31 15 34 128 37 37 37 37 37 37 37 37 22 13 5 5 5
5 5 5 30 11 11 11 11 15 34 1 1 1 1 1 1 1 1 1 36 13 12 34 1 1 1 1 36 13 12 18 13 20 21 5 34 36 10 11 11 11 11 11 11 11 11 5 5 5 5
5 5 5 5 5 5 5 5 12 34 1 1 1 1 1 1 1 1 1 36 13 12 34 1 1 1 1 36 13 12 18 13 23 133 5 34 36 13 5 5 5 5 5 5 5 5 5 5 5 5
5 5 5 5 5 5 5 5 12 34 1 1 1 1 1 1 1 1 1 36 13 12 34 1 1 1 1 36 13 12 18 13 15 18 5 34 36 13 5 5 5 5 5 5 5 5 5 5 5 5
5 5 5 5 5 5 5 5 12 34 1 1 1 1 1 1 1 1 1 36 13 12 34 1 1 1 1 36 13 12 18 13 12 18 5 34 36 13 5 5 5 5 5 5 5 5 5 5 5 5
5 5 5 5 5 5 5 5 12 34 1 1 1 1 1 1 1 1 1 36 13 12 34 1 1 1 1 36 13 12 18 13 12 18 5 34 36 13 5 5 5 5 5 5 5 5 5 5 5 5
5 5 5 5 5 5 5 5 12 34 1 1 1 1 1 1 1 1 1 36 13 12 34 1 1 1 1 36 13 12 18 13 12 18 5 34 36 13 5 5 5 5 5 5 5 5 5 5 5 5
5 5 5 5 5 5 5 5 12 34 1 1 1 1 1 1 1 1 1 36 13 12 34 1 1 1 1 36 13 12 18 13 12 18 5 34 36 13 5 5 5 5 5 5 5 5 5 5 5 5
5 5 5 5 5 5 5 5 12 34 1 1 1 1 1 1 1 1 1 36 13 12 34 1 1 1 1 36 13 12 18 13 12 18 5 34 36 13 5 5 5 5 5 5 5 5 5 5 5 5
5 5 5 5 5 5 5 5 12 34 1 1 1 1 1 1 1 1 1 36 13 12 34 1 1 1 1 36 13 12 18 13 12 18 5 34 36 13 5 5 5 5 5 5 5 5 5 5 5 5
5 5 5 5 5 5 5 5 12 34 1 1 1 1 1 1 1 1 1 36 13 12 34 1 1 1 1 36 13 12 18 13 12 18 5 34 36 13 5 5 5 5 5 5 5 5 5 5 5 5
5 5 5 5 5 5 5 5 12 34 1 1 1 1 1 1 1 1 1 36 13 12 34 1 1 1 1 36 13 12 18 13 12 18 5 34 36 13 5 5 5 5 5 5 5 5 5 5 5 5
5 5 5 5 5 5 5 5 12 34 1 1 1 1 1 1 1 1 1 36 13 12 34 1 1 1 1 36 13 12 18 13 12 18 5 34 36 13 5 5 5 5 5 5 5 5 5 5 5 5
5 5 5 5 5 5 5 5 12 34 1 1 1 1 1 1 1 1 1 36 13 12 34 1 1 1 1 36 13 12 18 13 12 18 5 34 36 13 5 5 5 5 5 5 5 5 5 5 5 5
5 5 5 5 5 5 5 5 12 34 1 1 1 1 1 1 1 1 1 36 13 12 34 1 1 1 1 36 13 12 18 17 16 18 5 34 36 13 5 5 5 5 5 5 5 5 5 5 5 5
5 5 5 5 5 5 5 5 12 34 1 1 1 1 1 1 1 1 1 36 13 12 34 1 1 1 1 36 13 12 43 19 39 42 5 34 36 13 5 5 5 5 5 5 5 5 5 5 5 5
5 5 5 5 5 5 5 5 12 34 1 1 1 1 1 1 1 1 1 36 13 12 34 1 1 1 1 36 13 5 31 25 18 10 5 34 36 13 5 5 5 5 5 5 5 5 5 5 5 5
5 5 5 5 5 5 5 5 12 34 1 1 1 1 1 1 1 1 1 36 13 12 34 1 1 1 1 36 13 5 44 19 42 5 5 34 36 13 5 5 5 5 5 5 5 5 5 5 5 5
5 5 5 5 5 5 5 5 12 34 1 1 1 1 1 1 1 1 1 36 17 16 34 1 1 1 1 36 13 5 18 29 14 14 5 34 36 13 5 5 5 5 5 5 5 5 5 5 5 5
5 5 5 5 5 5 5 5 12 23 37 37 37 37 37 37 37 37 37 138 19 19 142 1 1 1 1 36 13 5 131 35 35 21 5 34 36 13 5 5 5 5 5 5 5 5 5 5 5 5
5 5 5 5 5 5 5 5 30 11 11 11 11 11 11 11 11 11 11 11 11 15 23 37 37 37 37 22 13 5 23 37 37 22 5 34 36 13 5 5 5 5 5 5 5 5 5 5 5 5
5 14 14 14 14 14 14 5 5 5 5 5 5 5 5 5 5 5 5 5 5 5 11 11 11 11 11 11 5 5 11 11 11 11 12 34 36 13 5 5 5 5 5 5 5 5 5 5 5 5
12 20 35 35 35 35 21 13 5 5 5 5 5 5 5 5 5 5 5 5 5 5 5 5 5 5 5 5 5 5 5 5 5 5 12 34 36 13 5 5 5 5 5 5 5 5 5 5 5 5
12 34 1 1 1 1 36 13 5 5 5 5 5 5 5 5 5 5 5 5 5 5 5 5 5 5 5 5 5 5 5 5 5 5 12 34 36 13 5 5 5 5 5 5 5 5 5 5 5 5
12 34 1 1 1 1 36 13 5 5 5 5 5 5 5 5 5 5 5 5 5 5 5 5 5 5 5 5 5 5 5 5 5 5 12 34 36 13 5 5 5 5 5 5 5 5 5 5 5 5
12 34 1 1 1 1 36 17 14 14 14 14 14 14 14 14 14 14 14 14 14 14 14 14 14 14 14 14 14 14 14 14 14 14 12 34 36 13 5 5 5 5 5 5 5 5 5 5 5 5
12 135 7 129 1 1 140 19 19 19 19 19 19 19 19 19 19 19 19 19 19 19 19 19 19 19 19 19 19 19 19 19 19 19 19 134 22 13 5 5 5 5 5 5 5 5 5 5 5 5
12 43 19 134 37 37 22 10 11 11 11 11 11 11 11 11 11 11 11 11 11 11 11 11 11 11 11 11 11 11 11 11 11 11 11 11 11 5 5 5 5 5 5 5 5 5 5 5 5 5
30 11 11 11 11 11 11 5 5 5 5 5 5 5 5 5 5 5 5 5 5 5 5 5 5 5 5 5 5 5 5 5 5 5 5 5 5 5 5 5 5 5 5 5 5 5 5 5 5 5
