5 5 5 5 5 5 5 5 5 5 5 5 5 5 5 5 5 5 5 5 5 5 5 5 5 5 5 5 5 5 5 5 5 5 5 5 5 5 5 5 5 5 5 5 5 5 5 5 5 5 
5 20 39 19 45 5 5 5 5 5 5 5 5 5 5 5 5 5 1 1 1 5 1 1 1 1 1 1 19 19 19 19 19 19 19 19 19 19 19 19 19 19 19 19 19 19 19 19 1 5 
5 34 36 7 18 5 5 5 5 5 5 5 5 5 5 5 5 5 5 5 1 1 1 1 1 1 1 1 5 5 5 5 5 5 5 5 5 5 5 5 5 5 5 5 5 5 5 5 1 5 
5 34 24 35 24 19 19 19 19 45 5 5 5 5 5 5 5 5 5 5 5 5 5 5 5 5 5 1 1 1 1 1 5 5 5 1 1 1 1 1 1 19 19 19 19 19 19 1 1 5 
5 34 1 1 36 5 5 5 5 43 45 5 5 44 19 19 19 19 1 1 1 1 1 1 1 1 1 1 5 1 1 1 1 1 1 1 1 1 1 1 1 5 5 5 5 5 5 1 1 5 
5 34 1 24 22 5 5 5 5 5 18 5 44 42 5 5 5 5 1 1 1 1 1 1 1 1 1 1 1 1 1 1 1 5 1 5 5 5 5 5 5 5 5 5 5 5 5 1 1 5 
5 34 1 36 5 5 5 5 5 5 18 5 18 5 5 5 5 5 1 1 1 1 5 5 5 5 5 1 1 1 1 1 1 1 1 1 1 1 1 5 1 5 1 5 1 1 1 1 1 5 
32 34 1 24 21 5 5 5 5 5 18 5 43 45 5 5 5 5 5 1 1 5 5 5 5 5 5 1 1 1 1 1 5 1 5 1 1 5 1 1 1 1 1 1 1 1 1 5 18 5 
32 34 1 1 36 5 5 5 5 5 18 5 5 18 5 5 5 5 5 5 5 1 1 1 1 19 19 1 1 1 1 1 5 1 1 1 1 1 5 1 1 5 1 1 1 1 1 5 18 5 
5 34 24 37 40 5 5 5 5 5 18 5 5 18 5 44 19 19 45 5 5 5 1 1 1 5 5 1 5 5 1 5 1 1 5 1 1 1 5 5 5 5 5 5 5 1 1 5 18 5 
5 34 36 5 18 5 5 5 5 5 18 5 5 1 1 42 5 5 43 39 21 5 1 1 37 45 5 1 5 5 5 5 5 5 5 5 5 5 1 1 5 1 1 5 5 1 5 1 1 5 
5 38 22 5 18 5 5 5 5 5 18 5 5 1 1 5 5 5 5 38 22 5 5 18 5 18 5 1 1 5 1 5 1 5 5 1 5 1 5 1 1 5 1 1 1 1 1 1 1 5 
5 18 5 5 18 5 5 5 5 5 43 19 39 37 37 19 19 19 19 42 5 5 5 18 5 18 5 1 1 1 1 1 1 1 1 1 5 5 5 5 5 5 5 5 1 5 1 5 1 5 
5 18 5 20 40 5 20 35 21 5 5 5 18 5 5 5 5 5 5 5 5 5 5 18 5 18 5 1 5 5 1 1 1 1 1 5 5 5 5 5 5 5 5 5 1 1 5 1 1 5 
5 18 5 23 40 5 34 1 36 5 5 5 18 5 5 5 5 5 5 5 5 5 5 18 5 43 19 42 5 5 5 1 1 5 5 5 1 1 5 1 1 5 5 5 1 1 5 1 1 5 
5 18 5 5 18 5 34 1 36 5 5 5 18 5 1 19 19 19 19 19 19 19 19 42 5 5 5 5 5 5 1 1 1 1 1 1 1 1 5 1 1 1 1 1 1 5 1 5 1 5 
5 18 5 5 18 5 23 37 37 19 19 1 1 1 5 5 5 5 5 5 5 5 5 5 5 1 19 1 5 1 5 5 5 1 1 5 5 5 5 5 5 5 5 5 5 1 1 5 1 5 
5 18 5 5 5 5 5 5 5 5 5 1 1 5 5 5 5 5 5 5 5 5 5 5 1 1 5 5 5 5 1 1 1 1 1 1 1 5 5 5 5 5 5 5 5 18 5 1 1 5 
5 38 19 19 1 1 17 5 5 5 5 1 1 5 5 5 5 5 5 5 5 5 5 5 5 1 1 1 1 1 1 1 1 1 5 1 1 1 1 1 1 1 1 1 1 1 1 1 5 5 
32 18 5 5 1 1 17 5 5 5 5 5 1 5 5 5 5 5 5 5 5 5 5 1 1 1 1 1 1 1 1 1 5 5 5 5 1 1 1 1 1 1 1 1 5 5 5 5 5 5 
32 18 17 20 1 1 17 5 5 5 5 5 1 5 5 5 5 5 5 5 5 5 5 5 1 1 1 1 1 1 1 1 5 5 5 5 5 5 5 5 5 5 5 5 5 5 5 5 1 5 
32 18 17 18 5 1 17 5 5 5 5 5 1 1 1 1 1 1 1 1 1 5 5 5 5 5 5 1 1 1 1 1 5 5 5 5 5 5 5 5 5 5 5 5 5 5 5 1 1 5 
32 18 5 18 5 5 5 5 5 5 5 5 1 1 1 1 1 1 1 1 1 1 1 1 1 5 1 1 5 1 1 1 5 5 5 5 5 5 5 5 5 5 5 5 5 5 5 1 1 5 
32 18 5 18 5 5 1 1 1 1 1 1 1 1 1 1 1 5 1 1 1 1 1 1 5 5 1 5 1 1 1 1 5 5 5 5 5 5 5 5 5 5 5 5 5 5 5 1 1 5 
32 34 1 22 5 5 5 1 1 1 1 1 5 5 5 5 5 5 5 5 5 1 5 5 5 1 1 1 1 1 1 1 1 1 1 1 5 5 5 5 5 5 5 5 5 5 5 1 1 5 
32 34 22 5 5 5 5 5 1 1 1 1 1 1 1 1 1 1 1 1 1 1 1 1 1 1 5 5 1 1 1 5 5 5 5 5 1 1 1 1 1 1 5 5 5 5 5 1 1 5 
32 34 5 5 5 5 1 1 1 1 1 1 1 1 1 1 1 5 5 5 1 1 1 1 1 5 5 5 1 1 1 5 5 5 5 5 5 5 5 5 5 1 1 1 5 5 5 1 1 5 
32 34 21 5 5 5 5 1 1 1 1 5 1 1 1 1 1 1 5 5 1 1 1 1 5 1 1 1 1 1 1 1 1 1 5 5 5 5 5 5 5 5 5 5 1 5 5 1 1 5 
32 34 1 1 1 1 1 1 1 1 1 1 1 1 1 1 5 5 5 5 1 1 1 1 1 1 5 1 1 5 5 1 1 1 5 1 1 1 5 5 5 5 5 5 18 5 5 1 1 5 
32 34 36 5 23 1 1 1 1 1 1 1 1 1 1 1 1 1 1 1 1 1 1 1 1 1 1 5 1 1 1 1 5 5 1 5 5 1 1 1 1 1 1 1 1 5 5 1 1 5 
32 34 36 5 5 5 1 1 1 1 1 1 1 1 1 1 1 1 1 1 1 1 1 5 5 1 1 1 1 1 5 5 5 1 1 5 5 5 5 5 5 5 5 5 5 5 5 1 1 5 
32 34 1 21 5 5 1 1 1 1 1 1 1 1 1 1 1 1 1 1 1 1 1 1 1 1 1 1 1 1 5 5 5 18 5 5 5 5 5 5 5 5 5 5 5 1 1 1 1 5 
32 34 16 1 1 1 1 1 5 1 1 1 1 1 1 1 1 1 1 1 1 1 1 1 1 1 1 1 1 1 5 5 5 1 1 1 1 1 1 1 1 1 1 1 1 1 5 1 1 5 
32 34 35 1 1 1 1 1 1 1 1 1 1 1 1 1 1 1 1 1 1 1 1 1 1 1 1 1 1 1 5 5 5 5 1 1 1 1 1 1 1 1 5 5 5 5 5 1 1 5 
32 34 1 1 1 1 1 1 1 1 1 1 1 1 1 1 1 1 1 1 1 1 1 1 1 1 1 1 1 5 5 5 5 5 1 1 1 1 1 1 1 1 5 5 5 5 1 1 1 5 
32 34 1 1 1 1 1 1 1 1 1 1 1 1 1 1 1 1 1 1 1 1 1 1 1 1 1 5 5 19 39 19 1 1 1 1 1 5 5 5 5 5 5 5 5 5 1 1 1 5 
32 23 1 1 1 1 1 1 1 1 1 1 1 1 1 1 1 1 1 1 1 1 1 1 1 1 1 5 1 5 18 5 1 1 1 1 5 5 5 5 5 5 5 5 5 5 1 1 1 5 
5 5 34 1 1 1 1 1 1 1 1 1 1 1 1 1 1 1 1 1 1 1 1 1 1 1 1 15 18 5 18 5 1 1 1 1 5 5 5 5 5 5 5 5 5 1 1 1 1 5 
5 12 34 1 1 1 1 1 1 1 1 1 1 1 1 1 1 1 1 1 1 1 1 1 1 1 5 12 18 5 18 5 1 1 1 1 5 5 5 5 5 5 5 1 1 1 1 1 1 5 
5 12 34 1 1 1 1 1 1 1 1 1 1 1 1 1 1 1 1 1 1 1 1 1 5 5 5 16 18 5 18 5 5 5 5 1 5 5 1 1 1 1 1 1 1 1 1 1 1 5 
5 12 34 1 1 1 1 1 1 1 1 1 1 1 1 1 1 1 1 1 1 1 1 5 5 5 16 20 1 21 5 5 1 1 1 1 1 1 1 1 1 1 1 1 1 1 1 1 1 5 
5 16 34 1 1 1 1 1 36 10 5 5 15 23 1 10 5 15 1 1 1 1 1 5 5 12 20 1 1 1 1 1 1 1 1 1 1 1 1 1 1 1 1 1 1 1 1 1 1 5 
5 16 18 17 16 1 1 1 22 5 5 5 5 15 1 5 5 5 5 5 5 5 5 5 14 12 23 37 37 1 1 1 1 5 1 1 1 1 1 1 1 1 1 1 1 1 1 1 1 5 
5 16 38 19 19 1 36 10 5 5 5 5 5 5 5 5 5 5 5 5 5 5 5 12 18 17 14 5 15 34 1 1 5 5 5 5 5 5 1 1 1 1 1 1 1 1 1 1 1 5 
5 16 18 10 5 15 18 13 5 5 5 5 5 5 5 5 5 5 5 5 5 5 5 12 34 35 21 17 16 34 5 1 5 5 5 5 5 5 5 1 1 1 1 1 1 1 1 1 1 5 
5 16 18 17 5 16 18 17 14 14 14 14 14 14 14 14 14 14 14 14 14 14 14 16 34 37 37 19 19 41 19 1 19 19 19 1 1 1 1 1 1 1 1 1 1 1 1 1 1 5 
16 44 41 45 13 16 43 19 19 19 19 19 19 19 19 19 19 19 19 19 19 19 19 19 42 10 5 5 5 5 15 34 5 5 5 1 1 1 1 1 1 1 1 1 1 1 1 1 1 5 
16 18 7 18 13 5 11 11 11 11 11 11 11 11 11 11 5 5 5 5 5 5 5 5 5 5 5 5 5 5 12 23 19 19 19 1 1 1 1 1 1 1 1 1 1 1 1 1 1 5 
16 43 19 42 13 5 5 5 5 5 5 5 5 5 5 5 5 5 5 5 5 5 5 5 5 5 5 5 5 5 5 5 5 5 5 5 5 5 5 5 5 5 5 5 5 5 5 5 5 5 
5 11 11 11 5 5 5 5 5 5 5 5 5 5 5 5 5 5 5 5 5 5 5 5 5 5 5 5 5 5 5 5 5 5 5 5 5 5 5 5 5 5 5 5 5 5 5 5 5 5 
