5 5 5 5 5 5 5 5 5 5 5 5 5 5 5 5 5 5 5 5 5 5 5 5 5 5 5 5 5 5 5 5 5 5 5 5 5 5 5 5 5 5 5 5 5 5 5 5 5 5 
5 1 1 1 1 5 5 5 5 5 5 5 5 5 5 5 5 5 1 1 1 5 1 1 1 1 1 1 19 19 19 19 19 19 19 19 19 19 19 19 19 19 19 19 19 19 19 19 1 5 
5 1 1 7 18 5 5 5 5 5 5 5 5 5 5 5 5 5 5 5 1 1 1 1 1 1 1 1 5 5 5 5 5 5 5 5 5 5 5 5 5 5 5 5 5 5 5 5 1 5 
5 1 1 1 1 19 19 19 19 1 5 5 5 5 5 5 5 5 5 5 5 5 5 5 5 5 5 1 1 1 1 1 5 5 5 1 1 1 1 1 1 19 19 19 19 19 19 1 1 5 
5 1 1 1 1 5 5 5 5 1 1 5 5 1 19 19 19 19 1 1 1 1 1 1 1 1 1 1 5 1 1 1 1 1 1 1 1 1 1 1 1 5 5 5 5 5 5 1 1 5 
5 1 1 1 1 5 5 5 5 5 18 5 1 1 5 5 5 5 1 1 1 1 1 1 1 1 1 1 1 1 1 1 1 5 1 5 5 5 5 5 5 5 5 5 5 5 5 1 1 5 
5 18 5 5 5 5 5 5 5 5 18 5 18 5 5 5 5 5 1 1 1 1 5 5 5 5 5 1 1 1 1 1 1 1 1 1 1 1 1 5 1 5 1 5 1 1 1 1 1 5 
5 1 1 1 1 5 5 5 5 5 18 5 1 1 5 5 5 5 5 1 1 5 5 5 5 5 5 1 1 1 1 1 5 1 5 1 1 5 1 1 1 1 1 1 1 1 1 5 18 5 
5 1 1 1 1 5 5 5 5 5 18 5 5 18 5 5 5 5 5 5 5 1 1 1 1 19 19 1 1 1 1 1 5 1 1 1 1 1 5 1 1 5 1 1 1 1 1 5 18 5 
5 1 1 1 1 5 5 5 5 5 18 5 5 18 5 1 19 19 1 5 5 5 1 1 1 5 5 1 5 5 1 5 1 1 5 1 1 1 5 5 5 5 5 5 5 1 1 5 18 5 
5 1 1 5 1 5 5 5 5 5 18 5 5 1 1 1 5 5 1 1 1 5 1 1 1 1 5 1 5 5 5 5 5 5 5 5 5 5 1 1 5 1 1 5 5 1 5 1 1 5 
5 1 1 5 1 5 5 5 5 5 18 5 5 1 1 5 5 5 5 1 1 5 5 18 5 18 5 1 1 5 1 5 1 5 5 1 5 1 5 1 1 5 1 1 1 1 1 1 1 5 
5 18 5 5 1 5 5 5 5 5 1 19 1 1 1 1 1 1 1 1 5 5 5 18 5 18 5 1 1 1 1 1 1 1 1 1 5 5 5 5 5 5 5 5 1 5 1 5 1 5 
5 18 5 1 1 5 1 1 1 5 5 5 18 5 5 5 5 5 5 5 5 5 5 18 5 18 5 1 5 5 1 1 1 1 1 5 5 5 5 5 5 5 5 5 1 1 5 1 1 5 
5 18 5 1 1 5 1 1 1 5 5 5 18 5 5 5 5 5 5 5 5 5 5 18 5 1 1 1 5 5 5 1 1 5 5 5 1 1 5 1 1 5 5 5 1 1 5 1 1 5 
5 18 5 5 18 5 1 1 1 5 5 5 18 5 1 19 19 19 19 19 19 19 19 1 5 5 5 5 5 5 1 1 1 1 1 1 1 1 5 1 1 1 1 1 1 5 1 5 1 5 
5 18 5 5 18 5 1 1 1 19 19 1 1 1 5 5 5 5 5 5 5 5 5 5 5 1 19 1 5 1 5 5 5 1 1 5 5 5 5 5 5 5 5 5 5 1 1 5 1 5 
5 18 5 5 5 5 5 5 5 5 5 1 1 5 5 5 5 5 5 5 5 5 5 5 1 1 5 5 5 5 1 1 1 1 1 1 1 5 5 5 5 5 5 5 5 18 5 1 1 5 
5 1 1 1 1 1 17 5 5 5 5 1 1 5 5 5 5 5 5 5 5 5 5 5 5 1 1 1 1 1 1 1 1 1 5 1 1 1 1 1 1 1 1 1 1 1 1 1 5 5 
5 18 5 5 1 1 17 5 5 5 5 5 1 5 5 5 5 5 5 5 5 5 5 1 1 1 1 1 1 1 1 1 5 5 5 5 1 1 1 1 1 1 1 1 5 5 5 5 5 5 
5 18 17 1 1 1 17 5 5 5 5 5 1 5 5 5 5 5 5 5 5 5 5 5 1 1 1 1 1 1 1 1 5 5 5 5 5 5 5 5 5 5 5 5 5 5 5 5 1 5 
5 18 17 1 5 1 17 5 5 5 5 5 1 1 1 1 1 1 1 1 1 5 5 5 5 5 5 1 1 1 1 1 5 5 5 5 5 5 5 5 5 5 5 5 5 5 5 1 1 5 
5 18 5 1 5 5 5 5 5 5 5 5 1 1 1 1 1 1 1 1 1 1 1 1 1 5 1 1 5 1 1 1 5 5 5 5 5 5 5 5 5 5 5 5 5 5 5 1 1 5 
5 18 5 1 5 5 1 1 1 1 1 1 1 1 1 1 1 5 1 1 1 1 1 1 5 5 1 5 1 1 1 1 5 5 5 5 5 5 5 5 5 5 5 5 5 5 5 1 1 5 
5 1 1 1 5 5 5 1 1 1 1 1 5 5 5 5 5 5 5 5 5 1 5 5 5 1 1 1 1 1 1 1 1 1 1 1 5 5 5 5 5 5 5 5 5 5 5 1 1 5 
5 1 1 5 5 5 5 5 1 1 1 1 1 1 1 1 1 1 1 1 1 1 1 1 1 1 5 5 1 1 1 5 5 5 5 5 1 1 1 1 1 1 5 5 5 5 5 1 1 5 
5 1 5 5 5 5 1 1 1 1 1 1 1 1 1 1 1 5 5 5 1 1 1 1 1 5 5 5 1 1 1 5 5 5 5 5 5 5 5 5 5 1 1 1 5 5 5 1 1 5 
5 1 1 5 5 5 5 1 1 1 1 5 1 1 1 1 1 1 5 5 1 1 1 1 5 1 1 1 1 1 1 1 1 1 5 5 5 5 5 5 5 5 5 5 1 5 5 1 1 5 
1 1 1 1 1 1 1 1 1 1 1 1 1 1 1 1 5 5 5 5 1 1 1 1 1 1 5 1 1 5 5 1 1 1 5 1 1 1 5 5 5 5 5 5 18 5 5 1 1 5 
5 5 18 5 1 1 1 1 1 1 1 1 1 1 1 1 1 1 1 1 1 1 1 1 1 1 1 5 1 1 1 1 5 5 1 5 5 1 1 1 1 1 1 1 1 5 5 1 1 5 
5 5 18 5 5 5 1 1 1 1 1 1 1 1 1 1 1 1 1 1 1 1 1 5 5 1 1 1 1 1 5 5 5 1 1 5 5 5 5 5 5 5 5 5 5 5 5 1 1 5 
5 5 1 1 5 5 1 1 1 1 1 1 1 1 1 1 1 1 1 1 1 1 1 1 1 1 1 1 1 1 5 5 5 18 5 5 5 5 5 5 5 5 5 5 5 1 1 1 1 5 
5 14 16 1 1 1 1 1 5 1 1 1 1 1 1 5 14 14 5 1 1 1 17 5 5 5 1 1 1 1 5 5 5 1 1 1 1 1 1 1 1 1 1 1 1 1 5 1 1 5 
12 1 1 1 1 1 1 1 1 1 1 1 1 1 1 1 19 19 1 5 1 1 1 17 14 16 1 1 1 1 5 5 5 5 1 1 1 1 1 1 1 1 5 5 5 5 5 1 1 5 
12 1 1 1 1 1 1 1 1 1 1 1 10 5 1 1 10 5 5 12 1 1 1 1 1 1 1 5 5 5 5 5 5 5 1 1 1 1 1 1 1 1 5 5 5 5 1 1 1 5 
12 1 1 1 1 1 1 1 1 1 1 1 5 1 1 1 17 5 5 12 1 1 5 15 1 1 1 1 1 19 1 19 1 1 1 1 1 5 5 5 5 5 5 5 5 5 1 1 1 5 
12 1 1 1 1 1 1 1 1 1 1 1 5 18 5 1 1 5 5 12 1 1 5 12 1 1 1 1 1 5 18 5 1 1 1 1 5 5 5 5 5 5 5 5 5 5 1 1 1 5 
5 5 18 10 5 5 5 5 1 1 1 1 1 1 5 15 18 5 5 16 1 1 5 5 5 5 5 15 18 5 18 5 1 1 1 1 5 5 5 5 5 5 5 5 5 1 1 1 1 5 
5 12 18 5 12 1 1 1 1 1 10 5 5 5 5 12 18 17 16 1 1 17 14 14 5 5 5 12 18 5 18 5 1 1 1 1 5 5 5 5 5 5 5 1 1 1 1 1 1 5 
5 12 18 5 12 1 1 1 1 1 17 14 14 14 14 16 1 1 1 5 1 1 1 1 5 5 5 16 18 5 18 5 5 5 5 1 5 5 1 1 1 1 1 1 1 1 1 1 1 5 
5 12 18 5 12 1 1 1 1 1 1 1 1 1 1 1 1 1 1 17 5 1 1 5 5 5 16 1 1 1 5 5 1 1 1 1 1 1 1 1 1 1 1 1 1 1 1 1 1 5 
5 16 18 13 16 1 1 1 1 10 5 5 15 1 1 10 5 15 1 1 1 1 1 5 5 12 1 1 1 1 1 1 1 1 1 1 1 1 1 1 1 1 1 1 1 1 1 1 1 5 
5 16 18 17 16 1 1 1 1 5 5 5 5 15 1 5 5 5 5 5 5 5 5 5 14 12 1 1 1 1 1 1 1 5 1 1 1 1 1 1 1 1 1 1 1 1 1 1 1 5 
5 16 1 1 1 1 1 10 5 5 5 5 5 5 5 5 5 5 5 5 5 5 5 12 18 17 14 5 15 1 1 1 5 5 5 5 5 5 1 1 1 1 1 1 1 1 1 1 1 5 
5 16 18 10 5 15 18 13 5 5 5 5 5 5 5 5 5 5 5 5 5 5 5 12 18 19 1 17 16 1 5 1 5 5 5 5 5 5 5 1 1 1 1 1 1 1 1 1 1 5 
5 16 18 17 5 16 18 17 14 14 14 14 14 14 14 14 14 14 14 14 14 14 14 16 18 1 1 19 19 1 19 1 19 19 19 1 1 1 1 1 1 1 1 1 1 1 1 1 1 5 
16 1 1 1 13 16 1 19 19 19 19 19 19 19 19 19 19 19 19 19 19 19 19 19 1 10 5 5 5 5 15 1 5 5 5 1 1 1 1 1 1 1 1 1 1 1 1 1 1 5 
16 18 7 18 13 5 11 11 11 11 11 11 11 11 11 11 5 5 5 5 5 5 5 5 5 5 5 5 5 5 12 1 19 19 19 1 1 1 1 1 1 1 1 1 1 1 1 1 1 5 
16 1 1 1 13 5 5 5 5 5 5 5 5 5 5 5 5 5 5 5 5 5 5 5 5 5 5 5 5 5 5 5 5 5 5 5 5 5 5 5 5 5 5 5 5 5 5 5 5 5 
5 11 11 11 5 5 5 5 5 5 5 5 5 5 5 5 5 5 5 5 5 5 5 5 5 5 5 5 5 5 5 5 5 5 5 5 5 5 5 5 5 5 5 5 5 5 5 5 5 5 
