5 5 5 5 5 5 5 5 5 5 5 5 5 5 5 5 5 5 5 5 5 5 5 5 5 5 5 5 5 5 5 5 5 5 5 5 5 5 5 5 5 5 5 5 5 5 5 5 5 5 
5 1 1 1 1 5 5 5 5 5 5 5 5 5 5 5 5 5 1 1 1 5 1 1 1 1 1 1 1 1 1 1 1 1 1 1 1 1 1 1 1 1 1 1 1 1 1 1 1 5 
5 1 1 7 1 5 5 5 5 5 5 5 5 5 5 5 5 5 5 5 1 1 1 1 1 1 1 1 5 5 5 5 5 5 5 5 5 5 5 5 5 5 5 5 5 5 5 5 1 5 
5 1 1 1 1 1 1 1 1 1 5 5 5 5 5 5 5 5 5 5 5 5 5 5 5 5 5 1 1 1 1 1 5 5 5 1 1 1 1 1 1 1 1 1 1 1 1 1 1 5 
5 1 1 1 1 5 5 5 5 1 1 5 5 1 1 1 1 1 1 1 1 1 1 1 1 1 1 1 5 1 1 1 1 1 1 1 1 1 1 1 1 5 5 5 5 5 5 1 1 5 
5 1 1 1 1 5 5 5 5 5 1 5 1 1 5 5 5 5 1 1 1 1 1 1 1 1 1 1 1 1 1 1 1 5 1 5 5 5 5 5 5 5 5 5 5 5 5 1 1 5 
5 1 5 5 5 5 5 5 5 5 1 5 1 5 5 5 5 5 1 1 1 1 5 5 5 5 5 1 1 1 1 1 1 1 1 1 1 1 1 5 1 5 1 5 1 1 1 1 1 5 
5 1 1 1 1 5 5 5 5 5 1 5 1 1 5 5 5 5 5 1 1 5 5 5 5 5 5 1 1 1 1 1 5 1 5 1 1 5 1 1 1 1 1 1 1 1 1 5 1 5 
5 1 1 1 1 5 5 5 5 5 1 5 5 1 5 5 5 5 5 5 5 1 1 1 1 1 1 1 1 1 1 1 5 1 1 1 1 1 5 1 1 5 1 1 1 1 1 5 1 5 
5 1 1 1 1 5 5 5 5 5 1 5 5 1 5 1 1 1 1 5 5 5 1 1 1 5 5 1 5 5 1 5 1 1 5 1 1 1 5 5 5 5 5 5 5 1 1 5 1 5 
5 1 1 5 1 5 5 5 5 5 1 5 5 1 1 1 5 5 1 1 1 5 1 1 1 1 5 1 5 5 5 5 5 5 5 5 5 5 1 1 5 1 1 5 5 1 5 1 1 5 
5 1 1 5 1 5 5 5 5 5 1 5 5 1 1 5 5 5 5 1 1 5 5 1 5 1 5 1 1 5 1 5 1 5 5 1 5 1 5 1 1 5 1 1 1 1 1 1 1 5 
5 1 5 5 1 5 5 5 5 5 1 1 1 1 1 1 1 1 1 1 5 5 5 1 5 1 5 1 1 1 1 1 1 1 1 1 5 5 5 5 5 5 5 5 1 5 1 5 1 5 
5 1 5 1 1 5 1 1 1 5 5 5 1 5 5 5 5 5 5 5 5 5 5 1 5 1 5 1 5 5 1 1 1 1 1 5 5 5 5 5 5 5 5 5 1 1 5 1 1 5 
5 1 5 1 1 5 1 1 1 5 5 5 1 5 5 5 5 5 5 5 5 5 5 1 5 1 1 1 5 5 5 1 1 5 5 5 1 1 5 1 1 5 5 5 1 1 5 1 1 5 
5 1 5 5 1 5 1 1 1 5 5 5 1 5 1 1 1 1 1 1 1 1 1 1 5 5 5 5 5 5 1 1 1 1 1 1 1 1 5 1 1 1 1 1 1 5 1 5 1 5 
5 1 5 5 1 5 1 1 1 1 1 1 1 1 5 5 5 5 5 5 5 5 5 5 5 1 1 1 5 1 5 5 5 1 1 5 5 5 5 5 5 5 5 5 5 1 1 5 1 5 
5 1 5 5 5 5 5 5 5 5 5 1 1 5 5 5 5 5 5 5 5 5 5 5 1 1 5 5 5 5 1 1 1 1 1 1 1 5 5 5 5 5 5 5 5 1 5 1 1 5 
5 1 1 1 1 1 17 5 5 5 5 1 1 5 5 5 5 5 5 5 5 5 5 5 5 1 1 1 1 1 1 1 1 1 5 1 1 1 1 1 1 1 1 1 1 1 1 1 5 5 
5 1 5 5 1 1 17 5 5 5 5 5 1 5 5 5 5 5 5 5 5 5 5 1 1 1 1 1 1 1 1 1 5 5 5 5 1 1 1 1 1 1 1 1 5 5 5 5 5 5 
5 1 17 1 1 1 17 5 5 5 5 5 1 5 5 5 5 5 5 5 5 5 5 5 1 1 1 1 1 1 1 1 5 5 5 5 5 5 5 5 5 5 5 5 5 5 5 5 1 5 
5 1 17 1 5 1 17 5 5 5 5 5 1 1 1 1 1 1 1 1 1 5 5 5 5 5 5 1 1 1 1 1 5 5 5 5 5 5 5 5 5 5 5 5 5 5 5 1 1 5 
5 1 5 1 5 5 5 5 5 5 5 5 1 1 1 1 1 1 1 1 1 1 1 1 1 5 1 1 5 1 1 1 5 5 5 5 5 5 5 5 5 5 5 5 5 5 5 1 1 5 
5 1 5 1 5 5 1 1 1 1 1 1 1 1 1 1 1 5 1 1 1 1 1 1 5 5 1 5 1 1 1 1 5 5 5 5 5 5 5 5 5 5 5 5 5 5 5 1 1 5 
5 1 1 1 5 5 5 1 1 1 1 1 5 5 5 5 5 5 5 5 5 1 5 5 5 1 1 1 1 1 1 1 1 1 1 1 5 5 5 5 5 5 5 5 5 5 5 1 1 5 
5 1 1 5 5 5 5 5 1 1 1 1 1 1 1 1 1 1 1 1 1 1 1 1 1 1 5 5 1 1 1 5 5 5 5 5 1 1 1 1 1 1 5 5 5 5 5 1 1 5 
5 1 5 5 5 5 1 1 1 1 1 1 1 1 1 1 1 5 5 5 1 1 1 1 1 5 5 5 1 1 1 5 5 5 5 5 5 5 5 5 5 1 1 1 5 5 5 1 1 5 
5 1 1 5 5 5 5 1 1 1 1 5 1 1 1 1 1 1 5 5 1 1 1 1 5 1 1 1 1 1 1 1 1 1 5 5 5 5 5 5 5 5 5 5 1 5 5 1 1 5 
1 1 1 1 1 1 1 1 1 1 1 1 1 1 1 1 5 5 5 5 1 1 1 1 1 1 5 1 1 5 5 1 1 1 5 1 1 1 5 5 5 5 5 5 1 5 5 1 1 5 
5 5 1 5 1 1 1 1 1 1 1 1 1 1 1 1 1 1 1 1 1 1 1 1 1 1 1 5 1 1 1 1 5 5 1 5 5 1 1 1 1 1 1 1 1 5 5 1 1 5 
5 5 1 5 5 5 1 1 1 1 1 1 1 1 1 1 1 1 1 1 1 1 1 5 5 1 1 1 1 1 5 5 5 1 1 5 5 5 5 5 5 5 5 5 5 5 5 1 1 5 
5 5 1 1 5 5 1 1 1 1 1 1 1 1 1 1 1 1 1 1 1 1 1 1 1 1 1 1 1 1 5 5 5 1 5 5 5 5 5 5 5 5 5 5 5 1 1 1 1 5 
5 14 16 1 1 1 1 1 5 1 1 1 1 1 1 5 14 14 5 1 1 1 17 5 5 5 1 1 1 1 5 5 5 1 1 1 1 1 1 1 1 1 1 1 1 1 5 1 1 5 
12 1 1 1 1 1 1 1 1 1 1 1 1 1 1 1 1 1 1 5 1 1 1 17 14 16 1 1 1 1 5 5 5 5 1 1 1 1 1 1 1 1 5 5 5 5 5 1 1 5 
12 1 1 1 1 1 1 1 1 1 1 1 10 5 1 1 10 5 5 12 1 1 1 1 1 1 1 5 5 5 5 5 5 5 1 1 1 1 1 1 1 1 5 5 5 5 1 1 1 5 
12 1 1 1 1 1 1 1 1 1 1 1 5 1 1 1 17 5 5 12 1 1 5 15 1 1 1 1 1 1 1 1 1 1 1 1 1 5 5 5 5 5 5 5 5 5 1 1 1 5 
12 1 1 1 1 1 1 1 1 1 1 1 5 1 5 1 1 5 5 12 1 1 5 12 1 1 1 1 1 5 1 5 1 1 1 1 5 5 5 5 5 5 5 5 5 5 1 1 1 5 
5 5 1 10 5 5 5 5 1 1 1 1 1 1 5 15 1 5 5 16 1 1 5 5 5 5 5 15 1 5 1 5 1 1 1 1 5 5 5 5 5 5 5 5 5 1 1 1 1 5 
5 12 1 5 12 1 1 1 1 1 10 5 5 5 5 12 1 17 16 1 1 17 14 14 5 5 5 12 1 5 1 5 1 1 1 1 5 5 5 5 5 5 5 1 1 1 1 1 1 5 
5 12 1 5 12 1 1 1 1 1 17 14 14 14 14 16 1 1 1 5 1 1 1 1 5 5 5 16 1 5 1 5 5 5 5 1 5 5 1 1 1 1 1 1 1 1 1 1 1 5 
5 12 1 5 12 1 1 1 1 1 1 1 1 1 1 1 1 1 1 17 5 1 1 5 5 5 16 1 1 1 5 5 1 1 1 1 1 1 1 1 1 1 1 1 1 1 1 1 1 5 
5 16 1 13 16 1 1 1 1 10 5 5 15 1 1 10 5 15 1 1 1 1 1 5 5 12 1 1 1 1 1 1 1 1 1 1 1 1 1 1 1 1 1 1 1 1 1 1 1 5 
5 16 1 17 16 1 1 1 1 5 5 5 5 15 1 5 5 5 5 5 5 5 5 5 14 12 1 1 1 1 1 1 1 5 1 1 1 1 1 1 1 1 1 1 1 1 1 1 1 5 
5 16 1 1 1 1 1 10 5 5 5 5 5 5 5 5 5 5 5 5 5 5 5 12 1 17 14 5 15 1 1 1 5 5 5 5 5 5 1 1 1 1 1 1 1 1 1 1 1 5 
5 16 1 10 5 15 1 13 5 5 5 5 5 5 5 5 5 5 5 5 5 5 5 12 1 1 1 17 16 1 5 1 5 5 5 5 5 5 5 1 1 1 1 1 1 1 1 1 1 5 
5 16 1 17 5 16 1 17 14 14 14 14 14 14 14 14 14 14 14 14 14 14 14 16 1 1 1 1 1 1 1 1 1 1 1 1 1 1 1 1 1 1 1 1 1 1 1 1 1 5 
16 1 1 1 13 16 1 1 1 1 1 1 1 1 1 1 1 1 1 1 1 1 1 1 1 10 5 5 5 5 15 1 5 5 5 1 1 1 1 1 1 1 1 1 1 1 1 1 1 5 
16 1 7 1 13 5 11 11 11 11 11 11 11 11 11 11 5 5 5 5 5 5 5 5 5 5 5 5 5 5 12 1 1 1 1 1 1 1 1 1 1 1 1 1 1 1 1 1 1 5 
16 1 1 1 13 5 5 5 5 5 5 5 5 5 5 5 5 5 5 5 5 5 5 5 5 5 5 5 5 5 5 5 5 5 5 5 5 5 5 5 5 5 5 5 5 5 5 5 5 5 
5 11 11 11 5 5 5 5 5 5 5 5 5 5 5 5 5 5 5 5 5 5 5 5 5 5 5 5 5 5 5 5 5 5 5 5 5 5 5 5 5 5 5 5 5 5 5 5 5 5 
