5 5 5 5 5 5 5 5 5 5 5 5 5 5 5 5 5 5 5 5 5 5 5 5 5 5 5 5 5 5 5 5 5 5 5 5 5 5 5 5 5 5 5 5 5 5 5 5 5 5 
5 5 5 5 5 5 5 5 5 5 5 5 5 5 5 5 5 5 5 5 5 5 5 5 5 5 5 5 5 5 5 5 5 5 5 5 5 5 5 5 5 5 5 5 5 5 5 5 5 5 
5 5 5 5 5 5 5 5 5 5 5 5 5 5 5 5 5 5 5 5 5 5 5 5 5 5 5 5 5 5 5 5 5 5 5 5 5 5 5 5 5 5 5 5 5 5 5 5 5 5 
5 5 5 5 5 5 5 5 5 5 5 5 5 5 5 5 5 5 5 5 5 5 5 5 5 5 5 5 5 5 5 5 5 5 5 5 5 5 5 5 5 5 5 5 5 5 5 5 5 5 
5 5 5 5 5 5 5 5 5 5 5 5 5 5 5 5 5 5 5 5 5 5 5 5 5 5 5 5 5 5 5 5 5 5 5 5 5 5 5 5 5 5 5 5 5 5 5 5 5 5 
5 5 5 5 5 5 5 5 5 5 5 5 5 5 5 5 5 5 5 5 14 14 14 14 5 5 5 5 5 5 5 5 5 5 5 5 5 5 5 5 5 5 5 5 5 5 5 5 5 5 
5 5 5 5 5 5 5 5 5 5 5 5 5 5 5 5 5 5 5 12 20 35 35 21 17 14 5 5 5 5 5 5 5 5 5 5 5 5 5 5 5 5 5 5 5 5 5 5 5 5 
5 5 5 5 5 5 5 5 5 5 5 5 5 5 5 5 5 5 5 12 34 1 1 140 19 45 13 5 5 5 5 5 5 5 5 5 5 5 5 5 5 5 5 5 5 5 5 5 5 12 
5 5 5 5 5 5 5 5 5 5 5 5 5 5 5 5 5 5 5 12 23 37 37 22 32 18 13 5 5 5 5 5 5 5 5 5 5 5 5 5 5 5 5 5 5 5 5 5 5 12 
5 5 5 5 5 5 5 5 5 5 5 5 5 5 5 5 5 5 5 5 11 11 11 11 12 18 13 5 5 5 5 5 5 5 5 5 5 5 5 5 5 5 5 5 5 5 5 5 5 12 
5 5 5 5 5 5 5 5 5 5 5 5 5 5 5 5 5 5 5 5 5 5 5 5 12 18 13 5 5 5 5 5 5 5 5 5 5 5 5 5 5 5 5 5 5 5 5 5 5 12 
5 5 5 5 5 5 5 5 5 5 5 5 5 5 5 5 5 5 5 5 5 5 5 5 12 18 13 5 5 5 5 5 5 5 5 5 5 5 5 5 5 5 5 5 5 5 5 5 5 12 
5 5 5 5 5 5 5 5 5 5 5 5 5 5 5 5 5 5 5 5 5 5 5 5 12 18 13 5 5 5 5 5 5 5 5 5 5 5 5 5 5 5 5 5 5 5 5 5 5 12 
5 5 5 5 5 5 5 5 5 5 5 5 5 5 5 5 5 5 5 5 5 5 5 5 12 18 13 5 5 5 5 5 5 5 5 5 5 5 5 5 5 5 5 5 5 5 5 5 5 12 
5 5 5 5 5 5 5 5 5 5 5 5 5 5 5 5 5 5 5 5 5 5 5 5 12 18 13 5 5 5 5 5 5 5 5 5 5 5 5 5 5 5 5 5 5 5 5 5 5 12 
5 5 5 5 5 5 5 5 5 5 5 5 5 5 5 5 5 5 5 5 5 5 5 5 16 18 17 5 5 5 5 5 5 5 5 5 5 5 5 5 5 5 5 5 5 5 5 5 5 12 
5 5 5 5 5 5 5 5 5 5 5 5 5 5 5 5 5 14 14 14 14 14 14 16 20 139 21 17 14 14 14 14 14 5 5 5 5 5 5 5 5 5 5 5 5 5 5 5 5 12 
5 5 5 5 5 5 5 5 5 5 5 5 5 5 5 5 20 35 35 35 35 35 35 35 130 1 127 35 35 35 35 35 35 21 13 5 5 5 5 5 5 5 5 5 5 5 5 5 5 12 
5 5 5 5 5 5 5 5 5 5 5 5 5 5 5 12 34 1 1 1 1 1 1 1 1 1 1 1 1 1 1 1 1 36 17 5 5 5 5 5 5 5 5 5 5 5 5 5 5 12 
5 5 5 5 5 5 5 5 5 5 5 5 5 5 5 12 34 1 1 1 1 1 1 1 1 1 1 1 1 1 1 1 1 36 17 5 5 5 5 5 5 5 5 5 5 5 5 5 5 12 
5 5 5 5 5 5 5 5 5 5 5 5 5 5 5 12 34 1 1 1 1 1 1 1 1 1 1 1 1 1 1 1 1 36 17 5 5 5 5 5 5 5 5 5 5 5 5 5 5 12 
5 5 5 5 5 5 5 5 5 5 5 5 5 5 5 12 34 1 1 1 1 1 1 1 1 1 1 1 1 1 1 1 1 36 17 5 5 5 5 5 5 5 5 5 5 5 5 5 5 12 
5 5 5 5 5 5 5 5 5 5 5 5 5 5 5 12 34 1 1 1 1 1 1 1 1 1 1 1 1 1 1 1 1 36 17 5 5 5 5 5 5 5 5 5 5 5 5 5 5 12 
5 5 5 5 5 5 5 5 5 5 5 5 5 5 5 12 34 1 1 1 1 1 1 1 1 1 1 1 1 1 1 1 1 36 17 5 5 5 5 5 5 5 5 5 5 5 5 5 5 12 
5 5 5 5 5 5 5 5 5 5 5 5 5 5 5 12 34 1 1 1 1 1 1 1 1 1 1 1 1 1 1 1 1 36 17 5 5 5 5 5 5 5 5 5 5 5 5 5 5 12 
5 5 5 5 5 5 5 5 5 5 5 5 5 5 5 12 34 1 1 1 1 1 1 1 1 1 1 1 1 1 1 1 1 36 17 5 5 5 5 5 5 5 5 5 5 5 5 5 5 12 
5 5 5 5 5 5 5 5 5 5 5 5 5 5 5 12 34 1 1 1 1 1 1 1 1 1 1 1 1 1 1 1 1 36 17 5 5 5 5 5 5 5 5 5 5 5 5 5 5 12 
5 5 5 5 5 5 5 5 5 5 5 5 5 5 5 12 34 1 1 1 1 1 1 1 1 1 1 1 1 1 1 1 1 36 17 5 5 5 5 5 5 5 5 5 5 5 5 5 5 12 
5 5 5 5 5 5 5 5 5 5 5 5 5 5 5 12 34 1 1 1 1 1 1 1 1 1 1 1 1 1 1 1 1 36 17 5 5 5 5 5 5 5 5 5 5 5 5 5 5 12 
5 5 5 5 5 5 5 5 5 5 5 5 5 5 5 12 34 1 1 1 1 1 1 1 1 1 1 1 1 1 1 1 1 36 17 5 5 5 5 5 5 5 5 5 5 5 5 5 5 12 
5 5 5 5 5 5 5 5 5 5 5 5 5 5 5 12 34 1 1 1 1 1 1 1 1 1 1 1 1 1 1 1 1 36 17 5 5 5 5 5 5 5 5 5 5 5 5 5 5 5 
5 5 5 5 5 5 5 5 5 5 5 5 5 5 5 12 34 1 1 1 1 1 1 1 1 1 1 1 1 1 1 1 1 36 17 5 5 5 5 5 5 5 5 5 5 5 5 5 5 5 
5 5 5 5 5 5 5 5 5 5 5 5 5 5 5 12 34 1 1 1 1 1 1 1 1 1 1 1 1 1 1 1 1 36 17 5 5 5 5 5 5 5 5 5 5 5 5 5 5 5 
5 5 5 5 5 5 5 5 5 5 5 5 5 5 5 12 34 1 1 1 1 1 1 1 1 1 1 1 1 1 1 1 1 36 17 5 5 5 5 5 5 5 5 5 5 5 5 5 5 5 
5 5 5 5 5 5 5 5 5 5 5 5 5 5 5 12 34 1 1 1 1 1 1 1 1 1 1 1 1 1 1 1 1 36 17 5 5 5 5 5 5 5 5 5 5 5 5 5 5 5 
5 5 5 5 5 5 5 5 5 5 5 5 5 5 5 12 34 1 1 1 1 1 1 1 1 1 1 1 1 1 1 1 1 36 17 5 5 5 5 5 5 5 5 5 5 5 5 5 5 5 
5 5 5 5 5 5 5 5 5 5 5 5 5 5 5 12 34 1 1 1 1 1 1 1 1 1 1 1 1 1 1 1 1 36 17 5 5 5 5 5 5 5 5 5 5 5 5 5 5 5 
5 5 5 5 5 5 5 5 5 5 5 5 5 5 5 12 23 37 37 37 37 37 37 129 1 128 37 37 37 37 37 37 37 22 17 5 5 5 5 5 5 5 5 5 5 5 5 5 5 5 
5 5 5 5 5 5 5 5 5 5 5 5 5 5 5 30 11 11 11 11 11 11 15 23 141 22 10 11 11 11 11 11 11 5 5 5 5 5 5 5 5 5 5 5 5 5 5 5 5 5 
5 5 5 5 5 5 5 5 5 5 5 5 5 5 5 5 5 5 5 5 5 5 30 15 18 10 5 5 5 5 5 5 5 5 5 5 5 5 5 5 5 5 5 5 5 5 5 5 5 5 
5 5 5 5 5 5 5 5 5 5 5 5 5 5 5 5 5 5 5 5 5 5 5 12 18 13 5 5 5 5 5 5 5 5 5 5 5 5 5 5 5 5 5 5 5 5 5 5 5 5 
5 5 5 5 5 5 5 5 5 5 5 5 5 5 5 5 5 5 5 5 5 5 5 12 18 13 5 5 5 5 5 5 5 5 5 5 5 5 5 5 5 5 5 5 5 5 5 5 5 5 
5 5 5 5 5 5 5 5 5 5 5 5 5 5 5 5 5 5 5 5 5 5 5 12 18 13 5 5 5 5 5 5 5 5 5 5 5 5 5 5 5 5 5 5 5 5 5 5 5 5 
5 5 5 5 5 5 5 5 5 5 5 5 5 5 5 5 5 5 5 5 5 5 5 16 18 17 5 5 5 5 5 5 5 5 5 5 5 5 5 5 5 5 5 5 5 5 5 5 5 5 
5 5 5 5 5 5 5 5 5 5 5 5 5 5 5 5 5 5 5 5 5 5 5 44 41 45 13 5 5 5 5 5 5 5 5 5 5 5 5 5 5 5 5 5 5 5 5 5 5 5 
5 5 5 5 5 5 5 5 5 5 5 5 5 5 5 5 5 5 5 5 5 5 5 18 8 18 13 5 5 5 5 5 5 5 5 5 5 5 5 5 5 5 5 5 5 5 5 5 5 5 
5 5 5 5 5 5 5 5 5 5 5 5 5 5 5 5 5 5 5 5 5 5 5 43 19 42 13 5 5 5 5 5 5 5 5 5 5 5 5 5 5 5 5 5 5 5 5 5 5 5 
5 5 5 5 5 5 5 5 5 5 5 5 5 5 5 5 5 5 5 5 5 5 5 11 11 11 5 5 5 5 5 5 5 5 5 5 5 5 5 5 5 5 5 5 5 5 5 5 5 5 
5 5 5 5 5 5 5 5 5 5 5 5 5 5 5 5 5 5 5 5 5 5 5 5 5 5 5 5 5 5 5 5 5 5 5 5 5 5 5 5 5 5 5 5 5 5 5 5 5 5 
5 5 5 5 5 5 5 5 5 5 5 5 5 5 5 5 5 5 5 5 5 5 5 5 5 5 5 5 5 5 5 5 5 5 5 5 5 5 5 5 5 5 5 5 5 5 5 5 5 5 
