9 9 9 9 9 9 9 9 9 9 9 9 9 9 9 9 9 9 9 9 9 9 9 9 9 9 9 9 9 9 9 9 9 9 9 9 9 9 9 9 9 9 9 9 9 9 9 9 9 9 
9 9 2 2 2 2 9 9 9 9 9 9 9 9 9 9 9 9 9 9 9 9 9 9 9 9 9 9 9 9 9 9 9 9 9 9 9 9 9 9 9 9 9 9 9 9 9 9 9 9 
9 9 2 11 2 2 9 9 9 9 9 9 9 9 9 9 2 2 2 2 9 9 9 9 9 9 9 9 9 9 9 9 9 9 9 2 2 2 2 2 2 2 9 9 9 9 9 9 9 9 
9 9 2 2 2 2 9 9 9 9 9 9 9 9 9 9 2 2 9 2 9 9 9 2 2 2 2 2 2 2 2 2 2 2 2 2 2 2 2 2 2 2 2 2 9 9 9 9 9 9 
9 9 2 2 2 2 9 9 9 9 9 9 9 9 9 9 2 9 9 2 9 9 2 2 2 2 2 2 2 2 2 2 2 2 2 2 2 2 2 2 2 2 2 2 2 9 9 9 9 9 
9 9 9 9 2 2 9 9 9 9 9 9 9 9 9 9 2 9 2 2 9 9 2 2 2 2 9 9 9 9 9 9 9 9 9 2 2 2 2 2 2 2 2 2 2 9 9 9 9 9 
9 9 9 9 2 2 2 2 2 2 2 2 2 9 9 9 2 2 2 2 2 9 2 2 9 9 9 9 9 9 9 9 9 9 9 2 2 2 2 2 2 2 2 2 2 9 9 9 9 9 
9 9 9 9 9 2 2 2 2 2 2 2 2 9 9 9 9 2 2 2 2 2 2 2 9 9 9 9 9 9 9 9 9 9 9 2 2 2 2 2 2 2 2 2 2 2 9 9 9 9 
9 9 9 9 9 9 9 9 9 9 9 2 2 9 9 9 9 9 9 9 9 9 2 2 9 9 9 9 2 2 2 9 9 9 9 2 2 2 2 2 2 2 2 2 2 2 9 9 9 9 
9 9 9 9 9 9 9 9 9 9 9 2 2 9 9 9 9 9 9 9 2 2 2 2 9 9 9 9 2 9 2 9 9 9 9 9 9 2 2 2 2 2 2 2 2 2 9 9 9 9 
9 9 9 9 9 9 9 9 9 9 9 2 2 9 9 9 9 9 9 9 2 2 2 2 9 9 2 2 2 9 2 2 2 9 9 9 9 9 9 9 2 9 9 9 9 2 9 9 9 9 
9 9 9 9 9 9 9 9 9 9 9 2 2 9 9 9 9 9 9 9 2 2 9 9 9 9 2 9 9 9 9 9 2 9 9 9 9 9 9 9 2 9 9 9 9 2 9 9 9 9 
9 9 9 9 9 9 9 9 9 9 9 2 2 9 2 2 2 2 2 2 2 9 9 9 9 9 2 2 2 9 2 2 2 9 9 9 9 9 9 9 2 9 9 9 9 2 9 9 9 9 
9 9 9 9 9 9 9 9 9 9 9 2 2 9 2 9 9 2 2 2 2 9 9 9 9 9 9 9 2 9 2 2 2 2 2 2 2 2 2 2 2 9 9 9 9 2 9 9 9 9 
9 9 9 9 9 9 9 9 9 9 9 2 2 9 2 2 2 2 2 2 2 9 9 9 9 9 9 9 2 9 2 2 2 9 2 9 9 9 9 9 9 9 9 9 9 2 9 9 9 9 
9 9 9 9 9 9 9 9 9 9 9 2 2 9 9 9 9 9 9 9 2 9 9 9 9 9 9 9 2 9 2 2 2 2 2 9 9 9 9 9 9 9 9 9 9 2 9 9 9 9 
9 9 9 9 9 9 9 9 9 9 9 2 2 9 9 9 9 9 9 9 2 9 9 9 9 9 2 2 2 2 2 2 2 2 2 2 9 9 9 9 9 9 9 9 9 2 9 9 9 9 
9 9 9 9 9 9 9 9 2 2 2 2 2 2 2 2 2 2 2 2 2 9 9 9 9 9 2 2 2 2 9 9 9 2 9 9 9 9 9 9 9 9 2 2 2 2 2 2 2 9 
9 9 9 9 9 9 2 2 2 2 2 2 2 9 9 9 9 9 9 9 9 9 9 9 9 9 2 2 2 2 9 9 9 2 9 9 9 9 9 9 9 9 2 9 2 2 2 9 2 9 
9 9 9 9 9 9 2 9 2 2 2 2 2 9 9 9 9 9 9 9 9 2 2 2 2 2 2 2 2 2 9 9 2 2 9 9 9 9 9 9 9 9 2 9 2 9 2 9 2 9 
9 9 9 9 2 2 2 9 9 9 9 2 2 9 9 9 9 9 9 9 9 2 2 2 2 2 2 2 2 2 9 9 2 2 9 9 9 9 9 9 9 9 2 9 2 9 2 9 2 9 
9 9 9 9 2 2 2 9 9 9 9 2 2 9 9 9 9 9 9 9 9 2 2 9 9 9 2 2 2 2 2 9 9 9 9 9 9 9 9 9 9 9 2 9 2 9 2 9 2 9 
9 2 2 9 9 9 9 9 9 9 9 2 2 9 9 9 9 9 9 9 9 2 2 9 9 9 9 9 9 9 9 9 9 9 9 9 9 9 9 9 9 9 2 2 2 2 2 9 2 9 
9 2 2 2 2 2 9 9 9 9 9 2 2 9 9 9 9 9 9 9 9 2 2 9 9 9 9 9 9 9 9 2 2 2 2 2 2 2 2 2 2 9 9 2 2 2 9 9 2 9 
9 2 2 2 2 2 9 9 9 9 9 2 2 9 9 9 9 9 9 9 9 9 9 9 9 9 9 9 9 9 9 2 2 2 2 2 2 2 2 2 2 2 2 2 2 2 2 9 2 9 
9 2 2 2 2 2 9 9 9 9 9 2 2 9 9 9 9 9 9 9 9 9 9 9 9 9 9 9 9 9 9 2 2 2 9 9 9 9 2 2 2 2 2 2 2 2 2 2 2 9 
9 2 2 2 2 2 9 9 9 9 9 2 2 9 9 9 9 9 9 9 9 9 9 9 9 9 9 9 2 2 2 2 2 2 9 9 9 9 2 2 2 2 2 9 9 9 9 2 2 9 
9 9 9 9 9 2 9 9 9 9 9 2 2 9 9 9 9 2 2 9 9 9 9 9 9 9 2 2 2 2 9 9 9 9 9 9 9 9 2 2 2 2 2 2 2 9 9 2 2 9 
9 9 9 2 2 2 9 9 9 2 2 2 2 2 2 2 2 2 2 9 9 9 9 9 9 2 2 2 9 9 9 9 9 9 9 9 9 9 2 2 2 2 2 2 2 9 9 2 2 9 
9 9 9 2 9 9 9 9 9 2 2 2 2 2 2 2 2 2 2 9 9 9 9 9 9 2 9 9 9 9 9 9 9 9 9 9 9 9 2 2 2 2 2 2 2 2 9 9 2 9 
9 9 9 2 9 9 2 2 2 2 2 2 2 2 2 2 2 2 9 9 9 9 9 9 9 2 9 9 9 9 9 9 9 9 2 2 2 2 2 2 2 2 2 2 2 2 2 2 2 9 
9 9 9 2 9 9 2 2 2 2 2 2 2 2 2 2 2 2 2 2 2 2 2 2 2 2 2 2 2 2 2 2 2 2 2 9 9 9 2 2 2 2 2 2 2 2 2 2 9 9 
9 9 9 2 9 9 2 2 2 2 2 2 2 2 2 2 2 2 2 2 2 2 2 2 2 2 2 2 2 9 9 9 9 9 9 9 9 9 9 9 2 9 9 9 9 9 9 9 9 9 
9 9 9 2 2 2 2 2 2 2 2 2 2 9 9 9 9 9 9 9 9 2 9 9 9 9 9 9 9 9 9 9 9 9 9 9 9 9 9 9 2 9 9 9 9 9 9 9 9 9 
9 9 9 9 9 9 2 2 2 2 2 2 9 9 9 9 9 9 9 9 9 2 9 9 9 9 9 9 9 9 9 9 9 9 9 9 9 9 9 9 2 9 9 9 9 9 9 9 9 9 
9 9 9 9 9 9 9 9 2 2 9 9 9 9 9 9 9 9 9 9 9 2 9 9 9 9 9 9 9 9 9 9 9 9 9 9 9 9 9 9 2 9 9 9 9 9 9 9 9 9 
9 9 9 9 9 9 9 9 2 2 9 9 9 9 9 9 9 2 2 2 2 2 9 9 9 2 2 2 9 9 9 9 9 9 9 9 9 9 9 9 2 9 9 9 9 9 9 9 9 9 
9 9 9 9 9 9 9 9 2 2 9 9 9 9 9 9 9 2 2 9 9 9 9 9 9 2 2 2 9 9 9 9 9 2 2 2 2 2 2 2 2 9 9 9 9 9 9 9 9 9 
9 9 9 9 9 9 9 9 2 2 9 9 9 9 9 9 9 2 2 2 2 2 2 2 2 2 2 2 9 9 9 9 9 2 2 9 9 9 9 9 9 9 9 9 2 2 9 9 9 9 
9 9 9 9 9 9 9 9 2 2 9 9 9 9 9 9 9 2 2 2 2 2 2 2 2 2 2 9 9 9 9 9 9 9 2 9 9 9 9 9 9 9 9 9 2 2 9 9 9 9 
9 9 9 9 9 9 9 2 2 2 2 9 9 9 9 9 9 9 9 9 9 9 9 9 9 9 9 9 9 9 9 9 9 9 2 9 9 9 9 9 9 9 9 9 2 2 9 9 9 9 
9 9 9 9 9 9 9 2 2 2 2 9 9 9 9 9 9 9 9 9 9 9 9 9 9 9 9 9 9 9 2 2 2 2 2 9 9 9 9 9 9 9 9 9 2 2 9 9 9 9 
9 9 2 2 2 2 2 2 2 2 2 9 9 9 9 9 9 9 9 9 2 2 2 9 9 9 9 9 9 9 2 2 9 9 9 9 2 2 2 2 2 2 2 2 2 2 9 9 9 9 
9 9 2 9 9 9 2 2 2 2 2 9 9 9 9 9 9 9 9 9 2 2 2 2 2 2 2 2 9 9 2 2 9 9 9 9 2 2 2 2 2 2 2 2 2 2 9 9 9 9 
9 9 2 9 9 9 2 2 2 2 2 9 9 9 9 9 9 9 9 9 2 2 2 2 2 2 2 2 9 9 9 9 9 9 9 2 2 9 9 2 2 9 9 2 2 2 9 9 9 9 
9 9 2 9 9 9 9 2 2 2 2 2 2 2 2 2 2 9 9 9 2 9 9 9 9 2 9 9 9 9 9 9 9 9 9 2 2 9 9 2 2 9 9 9 9 9 9 9 9 9 
9 2 2 2 9 9 9 2 2 2 9 9 9 9 9 9 2 2 2 2 2 9 9 9 9 2 2 2 2 2 2 2 2 2 2 2 2 9 9 2 2 2 2 2 2 2 9 9 9 9 
9 2 12 2 9 9 9 9 9 9 9 9 9 9 9 9 9 9 9 9 9 9 9 9 9 9 9 9 9 2 2 2 2 2 2 2 2 9 9 2 2 2 2 2 2 2 9 9 9 9 
9 2 2 2 9 9 9 9 9 9 9 9 9 9 9 9 9 9 9 9 9 9 9 9 9 9 9 9 9 9 9 9 9 9 9 9 9 9 9 9 9 9 9 9 9 9 9 9 9 9 
9 9 9 9 9 9 9 9 9 9 9 9 9 9 9 9 9 9 9 9 9 9 9 9 9 9 9 9 9 9 9 9 9 9 9 9 9 9 9 9 9 9 9 9 9 9 9 9 9 9 
