5 5 5 5 5 5 5 5 5 5 5 5 5 5 5 5 5 5 5 5 5 5 5 5 5 5 5 5 5 5 5 5 5 5 5 5 5 5 5 5 5 5 5 5 5 5 5 5 5 5 
5 5 5 5 5 5 5 5 5 5 5 5 5 5 5 5 5 5 5 5 5 5 5 5 5 5 5 5 5 5 5 5 5 5 5 5 5 5 5 5 5 5 5 5 5 5 5 5 5 5 
5 5 5 5 5 5 5 5 5 5 5 5 5 5 5 5 5 5 5 5 5 5 5 5 5 5 5 5 5 5 5 5 5 5 5 5 5 5 5 5 5 5 5 5 5 5 5 5 5 5 
5 5 5 5 5 5 5 5 5 5 5 5 5 5 5 5 5 5 5 5 5 5 5 5 5 5 5 5 5 5 5 5 5 5 5 5 5 5 5 5 5 5 5 5 5 5 5 5 5 5 
5 5 5 5 5 5 5 5 5 5 5 5 5 5 5 5 5 5 5 5 5 5 5 5 5 5 5 5 5 5 5 5 5 5 5 5 5 5 5 5 5 5 5 5 5 5 5 5 5 5 
5 5 5 5 5 5 5 5 5 5 5 5 5 5 5 5 5 5 5 5 5 5 5 5 5 5 5 5 5 5 5 5 5 5 5 5 5 5 5 5 5 5 5 5 5 5 5 5 5 5 
5 5 5 5 5 5 5 5 5 5 5 5 5 5 5 5 5 5 5 5 20 35 35 21 5 5 5 5 5 5 5 5 5 5 5 5 5 5 5 5 5 5 5 5 5 5 5 5 5 5 
5 5 5 5 5 5 5 5 5 5 5 5 5 5 5 5 5 5 5 5 34 1 1 1 19 45 5 5 5 5 5 5 5 5 5 5 5 5 5 5 5 5 5 5 5 5 5 5 5 12 
5 5 5 5 5 5 5 5 5 5 5 5 5 5 5 5 5 5 5 5 23 37 37 22 5 18 5 5 5 5 5 5 5 5 5 5 5 5 5 5 5 5 5 5 5 5 5 5 5 12 
5 5 5 5 5 5 5 5 5 5 5 5 5 5 5 5 5 5 5 5 5 5 5 5 5 18 13 5 5 5 5 5 5 5 5 5 5 5 5 5 5 5 5 5 5 5 5 5 5 12 
5 5 5 5 5 5 5 5 5 5 5 5 5 5 5 5 5 5 5 5 5 5 5 5 5 18 13 5 5 5 5 5 5 5 5 5 5 5 5 5 5 5 5 5 5 5 5 5 5 12 
5 5 5 5 5 5 5 5 5 5 5 5 5 5 5 5 5 5 5 5 5 5 5 5 5 18 13 5 5 5 5 5 5 5 5 5 5 5 5 5 5 5 5 5 5 5 5 5 5 12 
5 5 5 5 5 5 5 5 5 5 5 5 5 5 5 5 5 5 5 5 5 5 5 5 5 18 13 5 5 5 5 5 5 5 5 5 5 5 5 5 5 5 5 5 5 5 5 5 5 12 
5 5 5 5 5 5 5 5 5 5 5 5 5 5 5 5 5 5 5 5 5 5 5 5 5 18 13 5 5 5 5 5 5 5 5 5 5 5 5 5 5 5 5 5 5 5 5 5 5 12 
5 5 5 5 5 5 5 5 5 5 5 5 5 5 5 5 5 5 5 5 5 5 5 5 5 18 13 5 5 5 5 5 5 5 5 5 5 5 5 5 5 5 5 5 5 5 5 5 5 12 
5 5 5 5 5 5 5 5 5 5 5 5 5 5 5 5 5 5 5 5 5 5 5 5 5 18 13 5 5 5 5 5 5 5 5 5 5 5 5 5 5 5 5 5 5 5 5 5 5 12 
5 5 5 5 5 5 5 5 5 5 5 5 5 5 5 5 5 14 14 14 14 14 14 5 20 1 21 5 14 14 14 14 14 5 5 5 5 5 5 5 5 5 5 5 5 5 5 5 5 12 
5 5 5 5 5 5 5 5 5 5 5 5 5 5 5 5 20 35 35 35 35 35 35 35 1 1 1 35 35 35 35 35 35 21 13 5 5 5 5 5 5 5 5 5 5 5 5 5 5 12 
5 5 5 5 5 5 5 5 5 5 5 5 5 5 5 12 34 1 1 1 1 1 1 1 1 1 1 1 1 1 1 1 1 36 17 5 5 5 5 5 5 5 5 5 5 5 5 5 5 12 
5 5 5 5 5 5 5 5 5 5 5 5 5 5 5 12 34 1 1 1 1 1 1 1 1 1 1 1 1 1 1 1 1 36 17 5 5 5 5 5 5 5 5 5 5 5 5 5 5 12 
5 5 5 5 5 5 5 5 5 5 5 5 5 5 5 12 34 1 1 1 1 1 1 1 1 1 1 1 1 1 1 1 1 36 17 5 5 5 5 5 5 5 5 5 5 5 5 5 5 12 
5 5 5 5 5 5 5 5 5 5 5 5 5 5 5 12 34 1 1 1 1 1 1 1 1 1 1 1 1 1 1 1 1 36 17 5 5 5 5 5 5 5 5 5 5 5 5 5 5 12 
5 5 5 5 5 5 5 5 5 5 5 5 5 5 5 12 34 1 1 1 1 1 1 1 1 1 1 1 1 1 1 1 1 36 17 5 5 5 5 5 5 5 5 5 5 5 5 5 5 12 
5 5 5 5 5 5 5 5 5 5 5 5 5 5 5 12 34 1 1 1 1 1 1 1 1 1 1 1 1 1 1 1 1 36 17 5 5 5 5 5 5 5 5 5 5 5 5 5 5 12 
5 5 5 5 5 5 5 5 5 5 5 5 5 5 5 12 34 1 1 1 1 1 1 1 1 1 1 1 1 1 1 1 1 36 17 5 5 5 5 5 5 5 5 5 5 5 5 5 5 12 
5 5 5 5 5 5 5 5 5 5 5 5 5 5 5 12 34 1 1 1 1 1 1 1 1 1 1 1 1 1 1 1 1 36 17 5 5 5 5 5 5 5 5 5 5 5 5 5 5 12 
5 5 5 5 5 5 5 5 5 5 5 5 5 5 5 12 34 1 1 1 1 1 1 1 1 1 1 1 1 1 1 1 1 36 17 5 5 5 5 5 5 5 5 5 5 5 5 5 5 12 
5 5 5 5 5 5 5 5 5 5 5 5 5 5 5 12 34 1 1 1 1 1 1 1 1 1 1 1 1 1 1 1 1 36 17 5 5 5 5 5 5 5 5 5 5 5 5 5 5 12 
5 5 5 5 5 5 5 5 5 5 5 5 5 5 5 12 34 1 1 1 1 1 1 1 1 1 1 1 1 1 1 1 1 36 17 5 5 5 5 5 5 5 5 5 5 5 5 5 5 12 
5 5 5 5 5 5 5 5 5 5 5 5 5 5 5 12 34 1 1 1 1 1 1 1 1 1 1 1 1 1 1 1 1 36 17 5 5 5 5 5 5 5 5 5 5 5 5 5 5 12 
5 5 5 5 5 5 5 5 5 5 5 5 5 5 5 12 34 1 1 1 1 1 1 1 1 1 1 1 1 1 1 1 1 36 17 5 5 5 5 5 5 5 5 5 5 5 5 5 5 5 
5 5 5 5 5 5 5 5 5 5 5 5 5 5 5 12 34 1 1 1 1 1 1 1 1 1 1 1 1 1 1 1 1 36 17 5 5 5 5 5 5 5 5 5 5 5 5 5 5 5 
5 5 5 5 5 5 5 5 5 5 5 5 5 5 5 12 34 1 1 1 1 1 1 1 1 1 1 1 1 1 1 1 1 36 17 5 5 5 5 5 5 5 5 5 5 5 5 5 5 5 
5 5 5 5 5 5 5 5 5 5 5 5 5 5 5 12 34 1 1 1 1 1 1 1 1 1 1 1 1 1 1 1 1 36 17 5 5 5 5 5 5 5 5 5 5 5 5 5 5 5 
5 5 5 5 5 5 5 5 5 5 5 5 5 5 5 12 34 1 1 1 1 1 1 1 1 1 1 1 1 1 1 1 1 36 17 5 5 5 5 5 5 5 5 5 5 5 5 5 5 5 
5 5 5 5 5 5 5 5 5 5 5 5 5 5 5 12 34 1 1 1 1 1 1 1 1 1 1 1 1 1 1 1 1 36 17 5 5 5 5 5 5 5 5 5 5 5 5 5 5 5 
5 5 5 5 5 5 5 5 5 5 5 5 5 5 5 12 34 1 1 1 1 1 1 1 1 1 1 1 1 1 1 1 1 36 17 5 5 5 5 5 5 5 5 5 5 5 5 5 5 5 
5 5 5 5 5 5 5 5 5 5 5 5 5 5 5 12 23 37 37 37 37 37 37 1 1 1 37 37 37 37 37 37 37 22 17 5 5 5 5 5 5 5 5 5 5 5 5 5 5 5 
5 5 5 5 5 5 5 5 5 5 5 5 5 5 5 30 11 11 11 11 11 11 15 23 1 22 5 11 11 11 11 11 11 5 5 5 5 5 5 5 5 5 5 5 5 5 5 5 5 5 
5 5 5 5 5 5 5 5 5 5 5 5 5 5 5 5 5 5 5 5 5 5 30 15 18 5 5 5 5 5 5 5 5 5 5 5 5 5 5 5 5 5 5 5 5 5 5 5 5 5 
5 5 5 5 5 5 5 5 5 5 5 5 5 5 5 5 5 5 5 5 5 5 5 5 18 13 5 5 5 5 5 5 5 5 5 5 5 5 5 5 5 5 5 5 5 5 5 5 5 5 
5 5 5 5 5 5 5 5 5 5 5 5 5 5 5 5 5 5 5 5 5 5 5 5 18 13 5 5 5 5 5 5 5 5 5 5 5 5 5 5 5 5 5 5 5 5 5 5 5 5 
5 5 5 5 5 5 5 5 5 5 5 5 5 5 5 5 5 5 5 5 5 5 5 5 18 13 5 5 5 5 5 5 5 5 5 5 5 5 5 5 5 5 5 5 5 5 5 5 5 5 
5 5 5 5 5 5 5 5 5 5 5 5 5 5 5 5 5 5 5 5 5 5 5 5 18 5 5 5 5 5 5 5 5 5 5 5 5 5 5 5 5 5 5 5 5 5 5 5 5 5 
5 5 5 5 5 5 5 5 5 5 5 5 5 5 5 5 5 5 5 5 5 5 5 44 41 45 5 5 5 5 5 5 5 5 5 5 5 5 5 5 5 5 5 5 5 5 5 5 5 5 
5 5 5 5 5 5 5 5 5 5 5 5 5 5 5 5 5 5 5 5 5 5 5 18 8 18 5 5 5 5 5 5 5 5 5 5 5 5 5 5 5 5 5 5 5 5 5 5 5 5 
5 5 5 5 5 5 5 5 5 5 5 5 5 5 5 5 5 5 5 5 5 5 5 43 19 42 5 5 5 5 5 5 5 5 5 5 5 5 5 5 5 5 5 5 5 5 5 5 5 5 
5 5 5 5 5 5 5 5 5 5 5 5 5 5 5 5 5 5 5 5 5 5 5 5 5 5 5 5 5 5 5 5 5 5 5 5 5 5 5 5 5 5 5 5 5 5 5 5 5 5 
5 5 5 5 5 5 5 5 5 5 5 5 5 5 5 5 5 5 5 5 5 5 5 5 5 5 5 5 5 5 5 5 5 5 5 5 5 5 5 5 5 5 5 5 5 5 5 5 5 5 
5 5 5 5 5 5 5 5 5 5 5 5 5 5 5 5 5 5 5 5 5 5 5 5 5 5 5 5 5 5 5 5 5 5 5 5 5 5 5 5 5 5 5 5 5 5 5 5 5 5 
