5 5 5 5 5 5 5 5 5 5 5 5 5 5 5 5 5 5 5 5 5 5 5 5 5 5 5 5 5 5 5 5 5 5 5 5 5 5 5 5 5 5 5 5 5 5 5 5 5 5
5 5 5 5 5 5 5 5 5 5 5 5 5 5 5 5 5 5 20 35 35 35 35 35 35 35 35 35 35 35 35 21 5 5 5 5 5 5 5 5 5 5 20 35 35 35 35 19 45 5
5 5 5 5 5 5 5 5 5 5 5 5 5 5 5 5 5 5 34 1 37 37 37 37 37 37 37 37 37 37 1 36 5 5 5 5 5 5 5 5 5 5 34 1 1 1 36 8 18 5
5 5 5 5 5 5 5 5 5 5 5 5 5 5 5 5 5 5 34 36 5 5 5 5 5 5 5 5 5 5 34 36 5 5 5 5 5 5 5 5 5 5 34 1 1 1 1 35 36 5
5 5 5 5 5 5 5 5 5 5 5 5 5 5 5 5 5 5 34 36 5 5 20 35 35 35 35 21 5 5 34 36 5 5 5 5 5 5 5 5 5 5 34 1 1 1 1 1 36 5
5 5 5 5 5 5 5 5 5 20 35 35 35 35 35 35 35 35 1 36 5 5 34 1 1 1 1 36 5 5 34 1 35 35 35 35 35 35 35 35 19 19 1 1 1 1 1 1 36 5
5 5 5 5 5 5 5 5 5 34 1 1 1 1 1 1 1 1 1 36 5 5 34 1 1 1 1 36 5 5 34 1 1 1 1 1 1 1 1 36 5 5 34 1 1 1 1 1 36 5
5 5 5 5 5 5 5 5 5 34 1 1 1 1 1 1 1 1 1 36 5 5 34 1 1 1 1 36 5 5 34 1 1 1 1 1 1 1 1 36 5 5 23 37 37 37 37 37 22 5
5 5 5 5 20 35 35 35 35 1 1 1 1 1 1 1 1 1 1 36 5 5 34 1 1 1 1 36 5 5 34 1 1 1 1 1 1 1 1 36 5 5 5 5 5 5 5 5 5 5
5 5 5 5 34 1 37 37 37 37 37 37 37 37 37 37 37 37 37 22 5 5 34 1 1 1 1 36 5 5 23 37 37 37 37 37 37 37 37 37 19 19 19 19 35 21 5 5 5 5
5 5 5 5 34 36 5 5 5 5 5 5 5 5 5 5 5 5 5 5 5 5 34 1 1 1 1 36 5 5 5 5 5 5 5 5 5 5 5 5 5 5 5 5 34 36 5 5 5 5
5 5 5 5 34 36 5 5 5 5 5 5 5 5 5 5 5 5 5 5 5 5 34 1 1 1 1 36 5 5 5 5 5 5 5 5 5 5 5 5 5 5 5 5 34 36 5 5 5 5
5 5 5 5 34 36 5 5 20 35 35 35 35 35 35 35 35 35 35 35 35 35 1 1 1 1 1 1 35 35 35 35 35 35 35 35 35 35 35 35 35 21 5 5 34 36 5 5 5 5
5 5 5 5 34 36 5 5 34 1 1 1 1 1 1 1 1 1 1 1 1 1 1 1 1 1 1 1 1 1 1 1 1 1 1 1 1 1 1 1 1 36 5 5 34 36 5 5 5 5
5 5 5 5 34 36 5 5 34 1 1 1 1 1 1 1 1 1 1 1 1 1 1 1 1 1 1 1 1 1 1 1 1 1 1 1 1 1 1 1 1 36 5 5 34 36 5 5 5 5
5 5 5 5 34 36 5 5 34 1 1 1 1 1 1 1 1 1 1 1 1 1 1 1 1 1 1 1 1 1 1 1 1 1 1 1 1 1 1 1 1 36 5 5 34 36 5 5 5 5
5 5 5 5 34 36 5 5 34 1 1 1 1 1 1 1 1 1 1 1 1 1 1 1 1 1 1 1 1 1 1 1 1 1 1 1 1 1 1 1 1 36 5 5 34 36 5 5 5 5
5 5 5 5 34 36 5 5 23 37 37 37 37 37 37 37 37 37 37 37 37 37 1 1 1 1 1 1 37 37 37 37 37 37 37 37 37 37 37 37 37 22 5 5 34 36 5 5 5 5
5 5 5 5 34 36 5 5 5 5 5 5 5 5 5 5 5 5 5 5 5 5 34 1 1 1 1 36 5 5 5 5 5 5 5 5 5 5 5 5 5 5 5 5 34 36 5 5 5 5
5 5 5 5 34 36 5 5 5 5 5 5 5 5 5 5 5 5 5 5 5 5 34 1 1 1 1 36 5 5 5 5 5 5 5 5 5 5 5 5 5 5 5 5 34 36 5 5 5 5
5 5 5 5 34 1 35 35 35 35 35 35 35 35 35 35 35 35 35 21 5 5 34 1 1 1 1 36 5 5 20 19 19 19 19 35 35 35 35 35 35 35 35 35 1 36 5 5 5 5
5 5 5 5 23 37 37 37 37 1 1 1 1 1 1 1 1 1 1 36 5 5 34 1 1 1 1 36 5 5 18 5 5 5 5 34 1 37 37 37 37 37 37 37 37 22 5 5 5 5
5 5 5 5 5 5 5 5 5 34 1 1 1 1 1 1 1 1 1 36 5 5 34 1 1 1 1 36 5 5 18 5 20 21 5 34 36 5 5 5 5 5 5 5 5 5 5 5 5 5
5 5 5 5 5 5 5 5 5 34 1 1 1 1 1 1 1 1 1 36 5 5 34 1 1 1 1 36 5 5 18 5 23 36 5 34 36 5 5 5 5 5 5 5 5 5 5 5 5 5
5 5 5 5 5 5 5 5 5 34 1 1 1 1 1 1 1 1 1 36 5 5 34 1 1 1 1 36 5 5 18 5 5 18 5 34 36 5 5 5 5 5 5 5 5 5 5 5 5 5
5 5 5 5 5 5 5 5 5 34 1 1 1 1 1 1 1 1 1 36 5 5 34 1 1 1 1 36 5 5 18 5 5 18 5 34 36 5 5 5 5 5 5 5 5 5 5 5 5 5
5 5 5 5 5 5 5 5 5 34 1 1 1 1 1 1 1 1 1 36 5 5 34 1 1 1 1 36 5 5 18 5 5 18 5 34 36 5 5 5 5 5 5 5 5 5 5 5 5 5
5 5 5 5 5 5 5 5 5 34 1 1 1 1 1 1 1 1 1 36 5 5 34 1 1 1 1 36 5 5 18 5 5 18 5 34 36 5 5 5 5 5 5 5 5 5 5 5 5 5
5 5 5 5 5 5 5 5 5 34 1 1 1 1 1 1 1 1 1 36 5 5 34 1 1 1 1 36 5 5 18 5 5 18 5 34 36 5 5 5 5 5 5 5 5 5 5 5 5 5
5 5 5 5 5 5 5 5 5 34 1 1 1 1 1 1 1 1 1 36 5 5 34 1 1 1 1 36 5 5 18 5 5 18 5 34 36 5 5 5 5 5 5 5 5 5 5 5 5 5
5 5 5 5 5 5 5 5 5 34 1 1 1 1 1 1 1 1 1 36 5 5 34 1 1 1 1 36 5 5 18 5 5 18 5 34 36 5 5 5 5 5 5 5 5 5 5 5 5 5
5 5 5 5 5 5 5 5 5 34 1 1 1 1 1 1 1 1 1 36 5 5 34 1 1 1 1 36 5 5 18 5 5 18 5 34 36 5 5 5 5 5 5 5 5 5 5 5 5 5
5 5 5 5 5 5 5 5 5 34 1 1 1 1 1 1 1 1 1 36 5 5 34 1 1 1 1 36 5 5 18 5 5 18 5 34 36 5 5 5 5 5 5 5 5 5 5 5 5 5
5 5 5 5 5 5 5 5 5 34 1 1 1 1 1 1 1 1 1 36 5 5 34 1 1 1 1 36 5 5 18 5 5 18 5 34 36 5 5 5 5 5 5 5 5 5 5 5 5 5
5 5 5 5 5 5 5 5 5 34 1 1 1 1 1 1 1 1 1 36 5 5 34 1 1 1 1 36 5 5 18 5 5 18 5 34 36 5 5 5 5 5 5 5 5 5 5 5 5 5
5 5 5 5 5 5 5 5 5 34 1 1 1 1 1 1 1 1 1 36 5 5 34 1 1 1 1 36 5 5 18 5 5 18 5 34 36 5 5 5 5 5 5 5 5 5 5 5 5 5
5 5 5 5 5 5 5 5 5 34 1 1 1 1 1 1 1 1 1 36 5 5 34 1 1 1 1 36 5 5 43 19 39 42 5 34 36 5 5 5 5 5 5 5 5 5 5 5 5 5
5 5 5 5 5 5 5 5 5 34 1 1 1 1 1 1 1 1 1 36 5 5 34 1 1 1 1 36 5 5 5 5 18 5 5 34 36 5 5 5 5 5 5 5 5 5 5 5 5 5
5 5 5 5 5 5 5 5 5 34 1 1 1 1 1 1 1 1 1 36 5 5 34 1 1 1 1 36 5 5 20 19 42 5 5 34 36 5 5 5 5 5 5 5 5 5 5 5 5 5
5 5 5 5 5 5 5 5 5 34 1 1 1 1 1 1 1 1 1 36 5 5 34 1 1 1 1 36 5 5 18 5 5 5 5 34 36 5 5 5 5 5 5 5 5 5 5 5 5 5
5 5 5 5 5 5 5 5 5 23 37 37 37 37 37 37 37 37 37 37 19 19 1 1 1 1 1 36 5 5 34 35 35 21 5 34 36 5 5 5 5 5 5 5 5 5 5 5 5 5
5 5 5 5 5 5 5 5 5 5 5 5 5 5 5 5 5 5 5 5 5 5 23 37 37 37 37 22 5 5 23 37 37 22 5 34 36 5 5 5 5 5 5 5 5 5 5 5 5 5
5 5 5 5 5 5 5 5 5 5 5 5 5 5 5 5 5 5 5 5 5 5 5 5 5 5 5 5 5 5 5 5 5 5 5 34 36 5 5 5 5 5 5 5 5 5 5 5 5 5
5 20 35 35 35 35 21 5 5 5 5 5 5 5 5 5 5 5 5 5 5 5 5 5 5 5 5 5 5 5 5 5 5 5 5 34 36 5 5 5 5 5 5 5 5 5 5 5 5 5
5 34 1 1 1 1 36 5 5 5 5 5 5 5 5 5 5 5 5 5 5 5 5 5 5 5 5 5 5 5 5 5 5 5 5 34 36 5 5 5 5 5 5 5 5 5 5 5 5 5
5 34 1 1 1 1 36 5 5 5 5 5 5 5 5 5 5 5 5 5 5 5 5 5 5 5 5 5 5 5 5 5 5 5 5 34 36 5 5 5 5 5 5 5 5 5 5 5 5 5
5 34 1 1 1 1 36 5 5 5 5 5 5 5 5 5 5 5 5 5 5 5 5 5 5 5 5 5 5 5 5 5 5 5 5 34 36 5 5 5 5 5 5 5 5 5 5 5 5 5
5 34 7 1 1 1 1 19 19 19 19 19 19 19 19 19 19 19 19 19 19 19 19 19 19 19 19 19 19 19 19 19 19 19 19 37 22 5 5 5 5 5 5 5 5 5 5 5 5 5
5 23 37 37 37 37 22 5 5 5 5 5 5 5 5 5 5 5 5 5 5 5 5 5 5 5 5 5 5 5 5 5 5 5 5 5 5 5 5 5 5 5 5 5 5 5 5 5 5 5
5 5 5 5 5 5 5 5 5 5 5 5 5 5 5 5 5 5 5 5 5 5 5 5 5 5 5 5 5 5 5 5 5 5 5 5 5 5 5 5 5 5 5 5 5 5 5 5 5 5
