6 6 6 6 6 6 6 6 6 6 6 6 6 6 6 6 6 6 6 6 6 6 6 6 6 6 6 6 6 6 6 6 6 6 6 6 6 6 6 6 6 6 6 6 6 6 6 6 6 6
6 6 6 6 6 6 6 6 6 6 6 6 6 6 6 6 6 6 6 6 6 6 6 1 1 1 1 1 1 1 1 1 1 1 1 1 1 1 1 1 1 1 1 1 6 6 6 6 6 6
6 6 6 6 6 6 1 1 1 1 1 1 1 1 6 6 6 6 6 6 6 6 6 1 1 1 1 1 1 1 1 1 1 1 6 6 6 6 6 1 1 1 1 1 1 1 1 1 6 6
6 6 6 6 6 6 1 1 1 1 1 1 1 1 1 1 1 1 1 1 6 6 6 1 1 1 1 1 1 1 1 1 1 6 6 6 6 6 6 6 1 1 1 1 1 1 1 1 6 6
6 6 1 1 1 1 1 1 1 1 1 1 1 1 1 1 1 1 1 1 1 1 6 1 1 1 30 30 30 30 1 1 1 6 6 6 6 6 6 6 1 1 32 32 1 1 1 1 6 6
6 6 1 1 1 1 1 1 1 1 1 1 1 1 1 1 1 1 1 1 1 1 1 1 1 1 1 1 1 1 1 1 1 1 6 6 6 6 6 1 1 1 1 1 1 1 1 1 6 6
6 6 1 1 1 1 1 1 1 1 1 1 1 1 1 1 1 1 1 1 1 1 1 1 1 1 1 1 1 1 1 1 1 1 1 1 1 1 1 1 1 1 1 1 1 1 1 1 6 6
6 6 1 1 1 1 2 2 2 2 2 2 2 2 2 2 2 2 2 2 2 1 1 1 1 1 1 1 1 1 1 1 1 1 1 1 1 1 1 1 1 1 1 1 1 1 1 1 6 6
6 6 1 1 1 1 2 2 2 2 2 2 2 2 2 2 2 2 2 2 2 1 1 2 2 2 2 2 2 2 2 2 2 2 2 2 2 2 2 2 2 1 1 1 1 1 1 1 1 6
6 6 1 1 1 1 2 2 4 4 4 4 4 4 4 4 4 4 4 2 2 1 1 2 2 2 2 2 2 2 2 2 2 2 2 2 2 2 2 2 2 1 1 1 1 1 1 1 1 6
6 6 1 1 1 1 2 2 4 4 4 4 4 4 4 4 4 4 4 2 2 1 1 2 2 2 2 2 2 2 2 2 2 2 2 2 2 2 2 2 2 1 1 1 1 1 1 1 1 6
6 6 6 6 1 1 2 2 4 4 4 4 4 4 4 4 4 4 4 2 2 1 1 2 2 2 4 4 4 4 4 4 4 4 4 4 4 4 4 2 2 1 1 1 1 1 1 1 1 6
6 6 6 1 1 1 2 2 4 4 4 4 4 4 4 4 4 4 4 2 2 1 1 2 2 2 4 4 4 4 4 4 4 4 4 4 4 4 4 2 2 1 1 1 1 1 1 1 1 6
6 6 6 1 1 1 2 2 2 2 2 2 2 2 2 2 2 2 2 2 2 1 1 2 2 2 4 4 4 4 4 4 4 4 4 4 4 4 4 2 2 1 1 6 1 1 1 1 1 6
6 6 6 1 1 1 2 2 2 2 2 2 2 2 2 2 2 2 2 2 2 1 1 2 2 2 4 4 4 4 4 4 4 4 4 4 4 4 4 2 2 1 1 6 1 1 1 1 1 6
6 6 6 1 1 1 2 2 2 13 13 2 2 2 2 2 2 2 2 2 2 1 1 2 2 2 2 2 2 2 2 2 2 2 2 2 2 2 2 2 2 1 1 6 1 1 1 1 1 6
6 6 6 1 1 1 2 2 2 13 13 2 2 2 2 2 2 2 2 2 2 1 1 2 2 2 2 2 2 2 2 2 2 2 2 2 2 2 2 2 2 1 1 6 1 1 1 1 1 6
6 6 6 1 1 1 2 2 2 13 13 2 2 2 2 2 2 2 2 2 2 1 1 2 2 2 2 2 2 2 2 2 2 2 2 2 2 2 2 2 2 1 1 6 1 1 1 1 1 6
6 30 1 1 1 1 2 2 2 13 13 2 2 2 2 2 2 2 2 2 2 1 1 2 2 2 2 2 2 2 2 2 2 2 2 2 2 2 2 2 2 1 1 6 1 1 1 1 1 6
6 30 1 1 1 1 2 2 2 13 13 2 2 2 2 2 2 2 2 2 2 1 1 2 5 5 2 2 2 2 2 2 2 2 2 2 2 2 2 2 2 1 1 6 1 1 1 1 1 6
6 30 1 1 1 1 2 2 2 13 13 2 2 2 2 2 2 2 2 2 2 1 1 2 5 5 2 2 2 2 2 2 2 2 2 2 2 2 2 2 2 1 1 6 1 1 1 1 1 6
6 30 1 1 1 1 2 2 2 2 2 2 2 2 2 2 2 2 2 2 2 1 1 2 5 5 2 2 2 2 2 2 2 2 2 2 2 2 2 2 2 1 1 1 1 1 1 1 1 6
6 30 1 1 1 1 2 2 2 2 2 2 2 2 2 2 2 2 2 2 2 1 1 2 5 5 2 2 2 2 2 2 2 2 2 2 2 2 2 2 2 1 1 1 1 1 1 1 1 6
6 30 1 1 1 1 2 2 2 2 2 2 2 2 2 2 2 2 2 2 2 1 1 2 5 5 2 2 2 2 2 2 2 2 2 2 2 2 2 2 2 1 1 1 1 1 1 1 1 6
6 30 1 1 1 1 2 2 2 2 2 2 2 2 2 2 2 2 2 2 2 1 1 2 5 5 2 2 2 2 2 2 2 2 2 2 2 2 2 2 2 1 1 42 42 1 1 1 1 6
6 1 1 1 1 1 2 2 2 2 2 2 2 2 2 2 2 2 2 2 2 1 1 2 2 2 2 2 2 5 5 5 5 5 5 5 2 2 2 2 2 1 1 42 42 1 1 1 1 6
6 1 1 1 1 1 1 1 1 1 1 1 1 1 2 2 2 1 1 1 1 1 1 2 2 2 2 2 2 2 2 2 2 2 2 2 2 2 2 2 2 1 1 42 42 1 1 1 1 6
6 1 1 1 30 1 1 1 1 1 1 1 1 1 2 2 2 1 1 1 1 1 1 2 2 2 2 2 2 2 2 2 2 2 2 2 2 2 2 2 2 1 1 42 42 1 1 1 1 6
6 1 1 1 30 1 1 1 1 1 1 1 1 1 2 2 2 1 1 1 1 1 1 1 1 1 1 1 1 1 1 1 1 1 2 2 2 1 1 1 1 1 1 1 1 1 1 1 1 6
6 1 1 1 30 1 1 1 1 1 1 1 1 1 2 2 2 1 1 1 1 1 1 1 1 1 1 1 1 1 1 1 1 1 2 2 2 1 1 1 1 21 21 21 21 21 1 1 1 6
6 1 1 1 30 1 1 1 2 2 2 2 2 2 2 2 2 2 2 2 2 2 2 2 2 2 2 2 2 2 2 2 2 2 2 2 2 2 2 2 2 2 2 2 2 1 1 1 1 6
6 1 1 1 30 1 1 1 2 2 2 2 2 4 4 4 4 4 4 2 2 2 2 2 2 2 5 5 5 5 5 5 5 5 5 5 5 5 5 5 5 5 2 2 2 1 1 1 1 6
6 1 1 1 30 1 1 1 2 2 2 2 4 4 4 4 4 4 4 4 2 2 2 2 2 2 2 2 2 2 2 2 2 2 2 2 2 2 2 2 2 2 2 2 2 1 1 1 1 6
6 1 1 1 30 1 1 1 2 2 2 4 4 4 4 4 4 4 4 4 4 2 2 2 2 2 2 2 2 2 2 2 2 2 2 2 2 2 2 2 2 2 2 2 2 1 1 1 1 6
6 1 1 1 1 1 1 1 2 2 2 2 4 4 4 4 4 4 4 4 2 2 2 2 2 30 30 30 30 30 30 30 30 2 2 2 2 2 2 2 2 2 2 2 2 1 1 1 1 6
6 1 1 1 1 1 1 1 2 2 2 2 2 4 4 4 4 4 4 2 2 2 2 2 2 30 30 30 30 30 30 30 30 2 2 2 2 2 2 2 2 2 2 2 2 1 1 1 1 6
6 1 1 1 1 1 1 1 2 2 2 2 2 2 2 2 2 2 2 2 2 2 2 2 2 2 2 2 2 2 2 2 2 2 2 2 2 2 2 2 2 2 2 2 2 1 1 1 1 6
6 1 1 1 1 1 1 1 2 2 2 2 2 2 2 2 2 2 2 2 2 2 2 2 2 2 2 2 2 2 2 2 2 2 2 2 2 2 2 2 2 2 2 2 2 1 1 1 1 6
6 1 1 1 1 1 1 1 2 2 2 2 2 2 2 2 2 2 2 2 2 2 2 2 2 2 2 2 2 2 2 30 30 30 2 2 2 2 2 2 2 2 2 2 2 1 1 1 1 6
6 1 1 1 1 1 1 1 2 2 2 2 2 2 2 2 2 2 2 2 2 2 2 2 2 2 2 2 2 2 2 2 2 2 2 2 2 2 2 2 2 2 2 2 2 1 1 1 1 6
6 1 1 1 1 8 1 1 2 2 2 2 2 2 2 2 2 2 2 2 2 2 2 2 2 2 2 2 2 2 2 2 2 2 2 2 2 2 2 44 44 44 2 2 2 1 1 1 1 6
6 1 1 1 1 1 1 1 2 2 2 2 2 2 2 2 2 2 2 2 2 2 2 2 2 2 2 2 2 2 2 2 2 2 2 2 2 2 2 44 44 44 2 2 2 1 1 1 1 6
6 1 7 1 1 1 1 1 2 2 2 2 2 2 2 2 2 2 2 2 2 2 2 2 2 2 2 35 35 35 35 35 35 35 35 35 2 2 2 44 44 44 2 2 2 1 1 1 1 6
6 1 1 1 1 8 1 1 2 2 2 2 2 2 2 2 2 2 2 2 2 2 2 2 2 2 2 35 35 35 35 35 35 35 35 35 2 2 2 2 2 2 2 2 2 1 1 1 1 6
6 1 1 1 1 1 1 1 2 2 2 2 2 2 2 2 2 2 2 2 2 2 2 2 2 2 2 2 2 2 2 2 2 2 2 2 2 2 2 2 2 2 2 2 2 1 1 1 6 6
6 6 6 1 1 1 1 1 1 1 1 1 1 1 1 1 1 1 1 1 1 1 1 1 1 1 1 1 1 1 1 1 1 1 1 1 1 1 44 44 44 1 1 1 1 1 1 1 6 6
6 6 6 1 1 1 1 1 1 1 1 1 1 1 1 1 1 1 35 35 35 35 35 35 35 1 1 1 1 1 1 1 1 1 1 1 1 1 44 44 44 1 1 1 1 1 1 1 6 6
6 6 6 1 1 1 1 6 1 1 1 1 1 1 1 1 1 1 35 35 35 35 35 35 35 35 35 35 35 35 35 35 1 1 1 1 1 1 44 44 44 1 44 44 44 1 1 1 6 6
6 6 6 6 1 1 6 6 6 6 6 1 1 1 1 1 1 1 35 35 35 35 35 35 35 6 6 6 6 6 6 1 1 1 1 1 1 1 1 1 1 1 1 1 1 1 1 6 6 6
6 6 6 6 6 6 6 6 6 6 6 6 6 6 6 6 6 6 6 6 6 6 6 6 6 6 6 6 6 6 6 6 6 6 6 6 6 6 6 6 6 6 6 6 6 6 6 6 6 6
