5 5 5 5 5 5 5 5 5 5 5 5 5 5 5 5 5 5 5 5 5 5 5 5 5 5 5 5 5 5 5 5 5 5 5 5 5 5 5 5 5 5 5 5 5 5 5 5 5 5 
5 3 3 3 3 3 3 3 3 3 3 3 3 3 3 3 3 3 3 3 3 3 3 19 19 19 19 19 19 19 19 19 19 19 19 19 19 19 19 19 19 19 19 19 19 19 19 19 3 5 
5 3 3 3 3 3 3 3 3 3 3 3 3 3 3 5 5 3 3 3 3 3 3 3 3 3 3 3 19 19 19 3 3 3 3 3 3 3 3 3 3 3 3 3 3 3 3 3 18 5 
5 3 3 3 3 3 3 5 5 5 3 3 3 3 3 5 3 3 3 3 3 3 3 3 3 3 3 3 3 3 3 3 3 3 3 6 6 3 3 3 3 3 3 3 3 3 3 3 18 5 
5 3 3 3 3 3 3 3 3 3 3 3 3 3 3 3 3 3 3 3 3 3 3 3 3 3 3 3 3 3 3 3 3 3 3 6 6 6 3 3 3 3 3 3 3 3 3 3 18 5 
5 3 3 3 3 3 3 3 3 3 3 3 3 3 3 3 3 3 2 2 3 3 3 3 3 3 3 3 3 3 3 3 3 3 6 6 6 6 6 6 3 3 3 3 3 3 3 3 18 5 
5 3 3 3 3 3 5 18 5 3 3 3 3 3 3 3 3 3 2 2 2 2 2 2 2 3 3 3 3 3 3 3 3 3 6 6 6 6 6 6 6 3 5 3 3 3 3 3 18 5 
5 3 3 5 5 5 5 3 3 3 5 5 18 5 3 3 5 3 2 2 2 2 2 2 2 2 2 2 3 3 3 3 3 3 3 6 6 6 6 6 6 3 3 3 3 3 3 3 18 5 
5 3 3 5 3 3 3 3 3 3 3 3 3 5 3 3 3 3 2 2 4 4 4 2 2 4 2 2 3 3 3 3 3 3 3 3 6 6 6 6 6 3 3 3 3 3 3 3 18 5 
12 3 3 5 18 5 5 5 5 5 5 12 3 3 3 2 2 2 2 2 4 4 4 2 2 2 2 2 2 3 3 3 3 3 3 3 3 6 6 6 6 6 3 3 3 3 3 3 18 5 
12 3 3 5 3 3 3 3 3 3 3 3 3 3 3 3 3 3 2 2 2 2 2 2 2 2 2 3 3 3 3 3 3 3 3 3 3 3 6 6 6 6 3 3 3 3 3 3 18 5 
12 3 3 3 3 3 3 3 3 3 3 3 3 3 5 3 3 2 2 2 2 4 4 4 2 2 2 2 2 2 2 2 3 3 3 3 3 3 3 3 3 3 3 3 3 3 3 3 18 5 
12 3 3 3 3 3 3 3 3 3 3 3 3 3 3 3 3 2 2 4 4 4 2 2 2 2 2 2 2 2 2 2 2 2 3 3 3 3 3 3 3 3 3 3 3 3 3 3 18 5 
12 3 3 3 3 5 5 3 3 3 3 3 3 3 3 3 2 2 2 2 2 2 2 2 4 2 2 2 2 2 2 2 2 2 3 3 3 3 3 3 3 3 3 3 3 3 3 15 18 13 
12 3 3 3 3 3 3 3 3 3 3 3 3 3 3 2 2 3 3 3 3 3 2 2 2 4 4 4 4 4 4 4 4 2 2 2 3 3 3 3 3 3 3 3 3 3 3 3 18 13 
12 3 3 5 18 5 5 3 3 3 3 3 3 3 3 2 3 3 3 3 2 2 2 2 2 2 2 2 4 2 2 4 4 2 2 2 2 3 3 3 3 3 3 3 3 3 3 3 18 13 
12 3 3 3 3 3 3 3 3 3 3 3 3 3 3 3 3 3 3 3 3 2 2 2 4 4 4 4 4 2 2 2 2 2 2 2 2 2 3 3 3 3 3 3 3 3 3 15 18 13 
12 3 3 10 11 11 11 11 11 11 11 15 3 3 3 3 3 3 3 3 3 3 3 3 2 2 2 2 2 3 3 3 3 3 3 3 3 2 2 3 3 3 3 3 3 3 3 12 18 13 
12 3 3 3 3 3 3 3 3 3 3 3 3 3 3 3 3 3 3 3 3 3 3 3 3 3 2 2 2 2 3 3 3 3 3 3 3 3 3 3 3 3 3 3 3 3 3 3 18 13 
12 3 3 3 3 3 3 3 3 3 3 3 3 3 3 3 3 3 3 3 3 3 3 3 3 3 3 3 3 3 3 3 3 3 3 3 3 3 3 3 3 3 3 3 3 3 3 3 18 13 
12 3 3 3 3 3 3 3 3 3 3 3 3 3 3 3 3 3 3 3 3 3 3 3 3 3 3 3 3 3 3 3 3 3 3 3 3 3 3 3 3 3 3 3 3 3 3 3 18 13 
12 3 3 3 3 3 3 3 3 3 3 3 3 3 3 3 3 3 3 3 3 3 3 3 3 3 3 3 3 3 3 3 3 3 3 3 3 3 3 3 3 3 3 3 3 3 3 3 18 13 
12 3 3 3 3 3 3 3 3 3 3 3 3 3 3 3 3 3 3 3 3 3 3 3 3 3 3 3 3 3 3 3 3 3 3 3 3 3 3 3 3 3 3 3 3 3 3 3 18 13 
12 3 3 3 3 3 3 3 3 3 3 3 3 3 3 3 3 3 3 3 3 3 5 5 3 3 3 3 3 3 3 3 3 3 3 3 3 3 3 3 3 3 3 3 3 3 3 3 18 13 
12 3 3 3 3 3 3 3 3 3 3 3 3 3 3 3 3 3 3 3 3 3 3 5 3 3 3 3 3 3 3 3 2 2 2 3 3 3 3 3 3 3 3 3 3 3 3 3 18 13 
12 3 3 3 3 3 3 3 3 3 3 3 3 3 3 3 3 3 3 3 3 3 3 3 3 3 3 3 3 3 3 3 2 2 2 3 3 3 3 3 3 3 3 3 3 3 3 3 18 13 
12 3 3 3 3 3 3 3 3 3 3 3 3 3 3 3 3 3 3 3 3 3 3 3 3 3 3 3 3 3 3 5 2 4 2 3 3 3 3 3 3 3 3 3 3 3 3 3 18 13 
12 3 3 3 3 3 3 3 3 3 3 3 3 3 3 3 3 3 3 3 3 3 3 3 3 3 3 3 3 3 3 3 2 2 2 3 3 3 3 3 3 3 3 3 3 3 3 3 18 13 
12 3 3 3 3 3 3 3 3 3 3 3 3 3 3 3 3 3 3 3 3 3 3 3 3 3 3 3 3 3 3 3 2 2 2 3 3 3 3 3 3 3 3 3 3 3 3 3 18 13 
12 3 3 3 3 3 3 3 3 3 3 3 3 3 3 3 3 3 3 3 3 3 3 3 3 3 3 3 3 3 3 3 3 3 3 3 3 3 3 3 3 3 3 3 3 3 3 3 18 13 
5 3 3 3 3 3 3 3 3 3 3 3 3 3 3 3 3 3 3 3 3 3 3 3 3 3 3 3 3 3 3 3 3 3 3 3 3 3 3 3 3 3 3 3 3 3 3 3 18 13 
5 3 3 3 3 3 3 3 3 3 3 3 3 3 3 3 5 5 5 5 5 5 3 3 3 3 3 3 3 3 2 2 2 2 2 2 2 2 2 2 3 3 3 3 3 2 2 2 18 13 
5 3 3 3 3 3 3 3 3 3 3 3 2 2 2 2 2 2 2 2 2 2 3 3 3 3 3 3 3 2 2 4 2 4 4 4 4 4 4 4 3 3 3 3 3 2 2 2 18 13 
5 3 3 3 3 3 3 3 3 3 3 2 2 2 2 2 2 2 2 2 2 2 3 3 3 3 3 2 3 4 2 4 2 4 2 2 2 2 2 2 2 2 2 2 2 2 2 2 18 13 
5 3 3 3 3 3 3 3 3 3 2 2 2 2 2 2 2 3 19 19 19 19 3 3 3 3 3 2 2 4 2 4 2 4 2 2 2 2 2 2 2 2 2 2 2 2 2 2 18 13 
12 3 3 3 3 3 3 2 2 6 6 6 6 6 6 2 2 18 2 2 2 2 2 3 3 3 2 2 2 4 4 4 4 4 2 2 2 2 2 2 2 2 2 2 2 2 2 2 18 13 
12 3 3 3 2 2 2 2 2 6 6 6 6 6 6 2 2 18 2 2 2 2 2 18 5 18 2 2 2 2 2 2 2 2 2 2 2 2 2 2 2 2 2 2 2 2 2 2 18 13 
12 3 3 5 5 5 5 2 2 6 6 6 6 6 6 2 2 18 2 2 2 2 2 18 5 18 2 2 2 2 2 2 2 2 2 2 2 2 2 2 2 2 2 2 2 2 2 2 18 13 
12 3 3 3 3 3 5 2 2 2 2 2 2 2 2 2 2 18 2 2 2 2 2 18 5 18 2 2 2 2 2 2 2 2 2 2 2 2 2 2 2 2 2 2 2 2 2 2 18 13 
12 3 3 3 3 3 5 2 2 2 2 2 2 2 2 2 3 3 19 19 19 19 19 18 5 18 2 2 2 2 2 2 2 2 2 2 2 2 2 2 2 2 2 2 2 2 2 2 18 13 
12 3 3 3 3 3 5 2 2 2 4 4 2 2 2 2 2 5 5 5 5 5 5 18 5 18 2 2 2 2 2 2 2 2 2 2 2 2 2 2 2 2 2 2 2 2 2 2 18 13 
12 3 3 1 1 1 5 2 2 2 4 2 2 2 2 2 2 5 3 19 19 3 3 18 5 18 2 2 2 2 2 2 2 2 2 2 2 2 2 2 2 2 2 2 2 2 2 2 18 13 
12 3 3 1 7 18 5 18 13 2 4 2 2 2 2 2 2 5 18 2 2 18 2 18 5 18 2 2 2 2 2 2 2 2 2 2 2 2 2 2 2 2 2 2 2 2 2 2 18 13 
12 3 3 1 1 1 5 0 13 0 4 2 6 2 9 2 2 5 18 2 2 18 2 18 5 18 2 2 2 2 2 2 2 2 2 2 2 2 2 2 2 2 2 2 2 2 2 2 18 13 
5 14 14 14 14 14 14 14 16 2 4 2 2 2 2 2 2 5 18 2 2 18 2 18 5 18 2 2 2 2 2 2 2 2 2 2 2 2 2 2 2 2 2 2 2 2 2 2 18 13 
12 3 19 19 19 19 19 19 19 2 4 4 4 4 4 4 2 5 18 2 3 3 2 18 5 18 2 2 2 2 2 2 2 2 2 2 2 2 2 2 2 2 2 2 2 2 2 2 18 13 
12 3 2 2 2 2 2 2 2 2 2 2 2 2 2 2 2 5 18 2 18 2 2 18 5 18 2 2 2 2 2 2 2 2 2 2 2 2 2 2 2 2 2 2 2 2 2 2 18 13 
12 3 2 2 2 2 2 2 2 2 2 2 2 2 2 2 3 5 3 3 3 2 2 18 5 18 2 2 2 2 2 2 2 2 2 2 2 2 2 2 2 2 2 2 2 2 2 2 18 13 
12 3 19 19 19 19 19 19 19 19 19 19 19 19 19 19 3 5 3 3 3 19 19 3 5 2 19 19 19 19 19 19 19 19 19 19 19 19 19 19 19 19 19 19 19 19 19 19 2 13 
5 5 5 5 5 5 5 5 5 5 5 5 5 5 5 5 5 5 5 5 5 5 5 5 5 5 5 5 5 5 5 5 5 5 5 5 5 5 5 5 5 5 5 5 5 5 5 5 5 5 
