6 6 6 6 6 6 6 6 6 6 6 6 6 6 6 6 6 6 6 6 6 6 6 6 6 6 6 6 6 6 6 6 6 6 6 6 6 6 6 6 6 6 6 6 6 6 6 6 6 6
6 6 6 6 6 6 6 6 6 6 6 6 6 6 6 6 6 6 6 6 6 6 6 6 6 6 6 6 6 6 6 6 6 6 6 6 6 6 6 6 6 6 6 6 6 6 6 6 6 6
6 6 6 6 6 6 6 6 6 6 6 6 6 6 6 6 6 6 6 6 6 6 6 6 6 6 6 6 6 6 6 6 6 6 6 6 6 6 6 6 6 6 6 6 6 6 6 6 6 6
6 6 6 6 6 6 6 6 6 6 6 6 6 6 6 6 6 6 6 6 6 6 6 6 6 6 6 6 6 6 6 6 6 6 6 6 6 6 6 6 6 6 6 6 6 6 6 6 6 6
6 6 6 6 6 6 6 6 6 6 6 6 6 6 6 6 6 6 6 6 6 6 6 6 6 6 6 6 6 6 6 6 6 6 6 6 6 6 6 6 6 6 6 6 6 6 6 6 6 6
6 6 6 6 6 6 6 6 1 1 6 6 6 6 6 6 6 6 6 6 6 6 6 6 6 6 6 6 6 6 6 6 6 6 6 6 1 1 1 1 1 6 6 6 6 6 6 6 6 6
6 6 6 6 6 6 1 1 1 1 1 6 6 6 6 6 6 6 6 6 6 6 6 6 6 6 6 6 6 6 6 6 6 6 6 1 1 1 2 2 2 2 1 6 6 6 6 6 6 6
6 6 6 6 6 1 1 2 2 2 1 1 1 1 1 1 1 1 1 1 1 1 1 1 1 1 1 1 1 1 1 1 1 1 1 1 1 2 2 4 4 4 2 2 6 6 6 6 6 6
6 6 6 6 6 1 2 2 2 2 1 1 1 1 2 2 2 2 2 2 2 2 2 2 2 2 2 2 2 2 2 2 2 2 2 2 2 2 4 4 4 4 4 4 2 6 6 6 6 6
6 6 6 6 6 1 2 2 2 1 1 2 2 2 2 2 2 2 2 2 2 2 2 2 2 2 2 2 2 4 4 4 4 4 4 4 4 4 4 4 4 4 4 2 1 6 6 6 6 6
6 6 6 6 6 1 2 2 1 1 2 2 2 2 2 2 2 4 4 4 4 4 4 4 4 4 4 4 4 4 4 4 4 4 4 4 4 4 4 4 4 2 2 1 1 6 6 6 6 6
6 6 6 6 6 1 2 1 1 2 2 2 4 2 2 2 4 4 4 4 4 4 4 4 4 4 4 4 4 4 2 2 2 4 4 4 4 4 4 2 2 2 1 1 6 6 6 6 6 6
6 6 6 6 6 1 1 1 1 2 2 4 4 4 2 4 4 4 4 4 4 4 4 4 4 4 4 4 4 4 2 4 2 4 2 2 9 4 4 2 1 1 1 6 6 6 6 6 6 6
6 6 6 6 6 6 1 1 1 2 2 4 4 4 2 4 4 4 4 2 2 2 2 2 2 2 2 4 4 2 2 4 2 4 2 4 4 4 4 2 1 1 6 6 6 6 6 6 6 6
6 6 6 6 6 6 6 6 1 2 2 4 4 4 2 4 4 4 4 4 4 4 4 4 4 4 2 4 4 2 4 4 2 4 2 4 4 4 4 2 1 1 6 6 6 6 6 6 6 6
6 6 6 6 6 6 6 6 1 1 2 2 4 2 2 4 4 4 4 4 4 4 4 4 4 4 2 4 4 2 4 2 2 4 2 2 2 2 4 2 2 1 6 6 6 6 6 6 6 6
6 6 6 6 6 6 6 1 1 2 2 2 2 2 4 4 4 4 4 4 4 4 4 4 4 4 2 4 4 2 4 2 4 4 4 4 4 2 4 4 2 1 6 6 6 6 6 6 6 6
6 6 6 6 6 6 1 1 2 2 2 4 4 4 4 4 4 2 2 2 2 2 2 2 2 2 2 2 4 2 4 2 4 2 2 2 4 2 4 4 2 1 6 6 6 6 6 6 6 6
6 6 6 6 6 6 1 2 2 2 4 4 4 4 4 2 2 2 4 4 4 4 4 4 4 2 2 2 2 2 4 2 4 2 4 2 2 2 4 4 2 1 1 6 6 6 6 6 6 6
6 6 6 6 6 6 6 2 2 2 4 2 2 2 4 2 4 4 4 4 4 4 4 4 4 4 4 2 4 4 4 2 2 2 4 4 4 4 4 4 2 1 1 6 6 6 6 6 6 6
6 6 6 6 6 6 2 4 4 2 4 2 4 2 4 2 2 2 4 4 4 4 4 4 4 2 2 2 4 4 4 4 4 4 4 4 4 4 4 4 2 1 1 1 6 6 6 6 6 6
6 6 6 6 6 2 2 4 4 2 2 2 4 2 4 2 2 2 2 2 2 2 2 2 2 2 2 2 2 2 2 2 2 2 2 2 2 2 4 4 2 2 1 1 6 6 6 6 6 6
6 6 6 6 6 2 2 4 4 4 4 4 4 2 2 2 1 1 1 1 1 1 1 1 1 1 1 1 1 1 1 1 1 1 1 1 1 2 4 4 4 2 2 1 6 6 6 6 6 6
6 6 6 6 6 2 2 4 4 4 4 4 4 2 2 2 1 1 1 1 1 1 1 1 1 1 1 1 1 1 1 1 1 1 1 1 1 2 4 4 4 2 2 1 6 6 6 6 6 6
6 6 6 6 6 6 2 4 4 4 4 2 2 2 2 2 2 2 2 2 2 2 2 2 1 1 1 1 2 2 2 2 2 2 2 2 2 2 4 4 4 2 1 1 6 6 6 6 6 6
6 6 6 6 6 6 2 4 4 4 4 2 4 4 4 4 4 4 4 4 4 4 4 2 2 1 1 2 2 4 4 4 4 4 4 4 4 4 4 4 2 2 1 1 6 6 6 6 6 6
6 6 6 6 6 6 2 4 4 4 4 2 4 2 2 2 2 2 2 2 2 4 4 4 2 1 1 2 2 2 2 2 2 2 2 2 2 2 2 4 2 1 1 6 6 6 6 6 6 6
6 6 6 6 6 6 2 4 4 4 4 2 4 2 2 2 2 2 2 2 2 4 4 4 2 1 1 2 4 4 4 4 4 4 4 4 4 4 2 4 2 1 1 6 6 6 6 6 6 6
6 6 6 6 6 6 2 4 4 4 4 2 4 2 2 2 2 2 2 2 2 4 4 4 2 1 1 2 4 4 2 2 2 2 2 2 2 4 2 4 2 1 1 6 6 6 6 6 6 6
6 6 6 6 6 6 2 2 4 4 4 2 2 2 2 2 2 2 2 2 4 4 4 4 2 1 1 2 4 4 2 4 4 4 4 4 2 4 2 4 2 1 1 6 6 6 6 6 6 6
6 6 6 6 6 6 6 2 4 4 4 4 4 4 4 4 4 4 4 2 4 4 4 4 2 1 1 2 4 4 2 4 2 2 2 2 2 4 2 4 2 1 1 6 6 6 6 6 6 6
6 6 6 6 6 6 6 2 4 4 4 4 4 4 4 4 4 4 4 2 2 2 4 4 2 1 1 2 4 4 2 4 4 4 4 4 4 4 2 4 2 1 6 6 6 6 6 6 6 6
6 6 6 6 6 6 6 6 2 2 2 2 4 4 4 4 4 4 4 4 4 2 4 4 2 1 1 2 4 4 2 2 2 2 2 2 2 2 2 4 2 1 6 6 6 6 6 6 6 6
6 6 6 6 6 6 6 6 6 6 6 2 2 2 2 2 4 4 2 2 2 2 4 4 2 1 1 2 4 4 4 4 4 4 4 4 4 4 4 2 2 1 6 6 6 6 6 6 6 6
6 6 6 6 6 6 6 6 1 1 6 6 6 6 2 2 2 2 2 4 4 4 4 4 2 1 1 2 2 2 4 4 4 2 2 2 2 2 2 2 2 1 6 6 6 6 6 6 6 6
6 6 6 6 6 6 6 6 1 1 1 1 1 6 6 6 2 4 4 4 2 4 4 4 2 1 1 1 1 2 4 4 2 2 1 1 1 1 1 2 2 1 6 6 6 6 6 6 6 6
6 6 6 6 6 6 6 6 1 1 2 2 1 1 1 1 1 2 2 2 2 4 4 4 2 2 2 2 1 2 4 4 2 1 1 6 6 6 1 1 2 1 6 6 6 6 6 6 6 6
6 6 6 6 6 6 6 1 1 1 1 1 1 1 1 2 1 6 6 1 2 2 2 4 4 4 2 2 1 2 2 2 2 1 6 6 6 6 6 1 2 1 6 6 6 6 6 6 6 6
6 6 6 6 6 6 1 1 2 1 10 31 31 25 1 2 1 6 6 1 1 1 2 4 4 4 4 2 1 1 1 1 1 1 6 6 6 6 6 1 2 1 6 6 6 6 6 6 6 6
6 6 6 6 6 6 1 1 2 1 29 8 1 1 1 2 1 1 6 6 6 1 2 2 2 4 4 2 2 2 2 2 2 1 1 6 6 6 1 1 2 1 1 6 6 6 6 6 6 6
6 6 6 6 6 6 6 1 1 1 17 31 31 25 1 2 2 1 1 6 6 1 1 1 2 2 2 2 2 2 2 2 2 2 1 1 1 1 1 2 2 2 1 6 6 6 6 6 6 6
6 6 6 6 6 6 6 6 1 1 1 1 1 1 1 2 2 1 1 6 6 6 1 1 1 1 1 1 1 1 1 1 1 1 1 2 2 2 2 2 2 1 1 6 6 6 6 6 6 6
6 6 6 6 6 6 6 6 6 1 1 1 2 2 2 2 1 1 6 6 6 6 6 6 6 6 6 6 6 6 6 6 6 6 1 1 1 2 2 1 1 1 6 6 6 6 6 6 6 6
6 6 6 6 6 6 6 6 6 6 6 1 1 1 1 1 1 6 6 6 6 6 6 6 6 6 6 6 6 6 6 6 6 6 6 6 1 1 1 1 6 6 6 6 6 6 6 6 6 6
6 6 6 6 6 6 6 6 6 6 6 6 6 6 6 6 6 6 6 6 6 6 6 6 6 6 6 6 6 6 6 6 6 6 6 6 6 6 6 6 6 6 6 6 6 6 6 6 6 6
6 6 6 6 6 6 6 6 6 6 6 6 6 6 6 6 6 6 6 6 6 6 6 6 6 6 6 6 6 6 6 6 6 6 6 6 6 6 6 6 6 6 6 6 6 6 6 6 6 6
6 6 6 6 6 6 6 6 6 6 6 6 6 6 6 6 6 6 6 6 6 6 6 6 6 6 6 6 6 6 6 6 6 6 6 6 6 6 6 6 6 6 6 6 6 6 6 6 6 6
6 6 6 6 6 6 6 6 6 6 6 6 6 6 6 6 6 6 6 6 6 6 6 6 6 6 6 6 6 6 6 6 6 6 6 6 6 6 6 6 6 6 6 6 6 6 6 6 6 6
6 6 6 6 6 6 6 6 6 6 6 6 6 6 6 6 6 6 6 6 6 6 6 6 6 6 6 6 6 6 6 6 6 6 6 6 6 6 6 6 6 6 6 6 6 6 6 6 6 6
6 6 6 6 6 6 6 6 6 6 6 6 6 6 6 6 6 6 6 6 6 6 6 6 6 6 6 6 6 6 6 6 6 6 6 6 6 6 6 6 6 6 6 6 6 6 6 6 6 6
