6 6 6 6 6 6 6 6 6 6 6 6 6 6 6 6 6 6 6 6 6 6 6 6 6 6 6 6 6 6 6 6 6 6 6 6 6 6 6 6 6 6 6 6 6 6 6 6 6 6
6 6 6 6 6 6 6 6 6 6 6 6 6 6 6 6 6 6 6 6 6 6 6 6 6 6 6 6 6 6 6 6 6 6 6 6 6 6 6 6 6 6 6 6 6 6 6 6 6 6
6 6 6 6 6 6 6 6 6 6 6 6 6 6 6 6 6 6 6 6 6 6 6 6 6 6 6 6 6 6 6 6 6 6 6 6 6 6 6 6 6 6 6 6 6 6 6 6 6 6
6 6 6 6 6 6 6 6 6 6 6 6 6 6 6 6 6 6 6 6 6 6 6 6 6 6 6 6 6 6 6 6 6 6 6 6 6 6 6 6 6 6 6 6 6 6 6 6 6 6
6 6 6 6 6 6 6 46 47 47 48 6 6 6 6 6 6 6 6 6 6 6 6 6 6 6 6 6 6 6 6 6 6 6 6 46 47 47 47 47 47 48 6 6 6 6 6 6 6 6
6 6 6 6 6 46 47 57 2 2 56 48 6 6 6 6 6 6 6 6 6 6 6 6 6 6 6 6 6 6 6 6 6 6 46 57 2 2 2 2 2 56 47 48 6 6 6 6 6 6
6 6 6 6 46 57 2 2 2 2 2 56 47 47 47 47 47 47 47 47 47 47 47 47 47 47 47 47 47 47 47 47 47 47 57 2 2 2 2 2 2 2 2 56 48 6 6 6 6 6
6 6 6 6 49 2 2 2 2 2 2 2 2 2 2 2 2 2 2 2 2 2 2 2 2 2 2 2 2 2 2 2 2 2 2 2 55 63 60 4 4 4 2 2 56 48 6 6 6 6
6 6 6 6 49 2 2 2 2 2 1 1 1 1 2 2 2 2 2 2 2 2 2 2 2 2 2 2 2 2 2 2 2 2 2 2 56 57 4 4 4 4 4 4 2 50 6 6 6 6
6 6 6 6 49 2 2 2 2 1 1 2 2 2 2 2 2 2 2 2 2 2 2 58 61 61 61 61 60 4 4 4 4 4 4 4 4 4 4 4 4 4 4 2 2 50 6 6 6 6
6 6 6 6 49 2 2 2 1 1 2 2 2 2 2 2 2 4 4 4 4 4 4 4 4 4 4 4 4 4 4 4 4 4 4 4 4 4 4 4 4 2 2 2 2 50 6 6 6 6
6 6 6 6 49 2 2 1 1 2 2 2 4 2 2 2 4 4 4 4 4 4 4 4 4 4 4 4 4 4 2 2 2 4 4 4 4 4 4 2 2 2 1 2 55 53 6 6 6 6
6 6 6 6 49 2 1 1 1 2 2 4 4 4 2 4 4 4 4 4 4 4 4 4 4 4 4 4 4 4 2 4 2 4 2 2 9 4 4 2 1 1 2 55 53 6 6 6 6 6
6 6 6 6 51 54 2 2 2 2 2 4 4 4 2 4 4 4 4 2 2 2 2 2 2 2 2 4 4 2 2 4 2 4 2 4 4 4 4 2 70 1 55 53 6 6 6 6 6 6
6 6 6 6 6 51 52 54 2 2 2 4 4 4 2 4 4 4 4 4 4 4 4 4 4 4 2 4 4 2 4 4 2 4 2 4 4 4 4 2 1 1 50 6 6 6 6 6 6 6
6 6 6 6 6 6 46 57 2 2 2 2 4 2 2 4 4 4 4 4 4 4 4 4 4 4 2 4 4 2 4 2 2 4 2 2 2 2 4 2 2 70 50 6 6 6 6 6 6 6
6 6 6 6 6 46 57 2 2 2 2 2 2 2 4 4 4 4 4 4 4 4 4 4 4 4 2 4 4 2 4 2 4 4 4 4 4 2 4 4 2 70 50 6 6 6 6 6 6 6
6 6 6 6 6 49 2 2 2 2 2 4 4 4 4 4 4 2 2 2 2 2 2 2 2 2 2 2 4 2 4 2 4 2 2 2 4 2 4 4 2 70 56 48 6 6 6 6 6 6
6 6 6 6 6 49 2 2 2 2 4 4 4 4 4 2 2 2 4 4 4 4 4 4 4 2 2 2 2 2 4 2 4 2 4 2 2 2 4 4 2 70 2 50 6 6 6 6 6 6
6 6 6 6 6 49 2 2 2 2 4 2 2 2 4 2 4 4 4 4 4 4 4 4 4 4 4 2 4 4 4 2 2 2 4 4 4 4 4 4 2 70 2 56 48 6 6 6 6 6
6 6 6 6 6 49 2 4 4 2 4 2 4 2 4 2 2 2 4 4 4 4 4 4 4 2 2 2 4 4 4 4 4 4 4 4 4 4 4 4 2 1 2 2 50 6 6 6 6 6
6 6 6 6 6 49 2 4 4 2 2 2 4 2 4 2 2 2 2 2 2 2 2 2 2 2 2 2 2 2 2 2 2 2 2 2 2 2 4 4 2 2 1 2 50 6 6 6 6 6
6 6 6 6 6 49 2 4 4 4 4 4 4 2 2 2 1 72 72 72 72 72 72 72 72 72 72 72 72 72 72 72 72 72 72 72 1 2 4 4 4 2 2 2 50 6 6 6 6 6
6 6 6 6 6 49 2 4 4 4 4 4 4 2 2 2 1 71 71 71 71 71 71 1 1 1 1 1 1 71 71 71 71 71 71 71 1 2 4 4 4 2 2 2 50 6 6 6 6 6
6 6 6 6 6 49 2 4 4 4 4 2 2 2 2 2 2 2 2 2 2 2 2 2 1 1 1 1 2 2 2 2 2 2 2 2 2 2 4 4 4 2 1 2 50 6 6 6 6 6
6 6 6 6 6 49 2 4 4 4 4 2 4 4 4 4 4 4 4 4 4 4 4 2 2 70 69 2 2 4 4 4 4 4 4 4 4 4 4 4 2 2 1 2 50 6 6 6 6 6
6 6 6 6 6 49 2 4 4 4 4 2 4 2 2 2 2 2 2 2 2 4 4 4 2 70 69 2 2 2 2 2 2 2 2 2 2 2 2 4 2 2 2 55 53 6 6 6 6 6
6 6 6 6 6 49 2 4 4 4 4 2 4 2 2 2 2 2 2 2 2 4 4 4 2 70 69 2 4 4 4 4 4 4 4 4 4 4 2 4 2 2 2 50 6 6 6 6 6 6
6 6 6 6 6 49 2 4 4 4 4 2 4 2 2 2 2 2 2 2 2 4 4 4 2 70 69 2 4 4 2 2 2 2 2 2 2 4 2 4 2 2 2 50 6 6 6 6 6 6
6 6 6 6 6 49 2 2 4 4 4 2 2 2 2 2 2 2 2 2 4 4 4 4 2 70 69 2 4 4 2 4 4 4 4 4 2 4 2 4 2 2 2 50 6 6 6 6 6 6
6 6 6 6 6 51 54 2 4 4 4 4 4 4 4 4 4 4 4 2 4 4 4 4 2 70 69 2 4 4 2 4 2 2 2 2 2 4 2 4 2 2 2 50 6 6 6 6 6 6
6 6 6 6 6 6 49 2 4 4 4 4 4 4 4 4 4 4 4 2 2 2 4 4 2 70 69 2 4 4 2 4 4 4 4 4 4 4 2 4 2 2 55 53 6 6 6 6 6 6
6 6 6 6 6 6 49 2 2 2 2 2 4 4 4 4 4 4 4 4 4 2 4 4 2 70 69 2 4 4 2 2 2 2 2 2 2 2 2 4 2 2 50 6 6 6 6 6 6 6
6 6 6 6 6 6 51 63 61 61 64 2 2 2 2 4 4 4 2 2 2 2 4 4 2 70 69 2 4 4 4 4 4 4 4 4 4 4 4 2 2 2 50 6 6 6 6 6 6 6
6 6 6 6 6 6 6 49 2 2 66 61 61 64 2 2 2 2 2 4 4 4 4 4 2 70 69 2 2 2 4 4 4 2 2 2 2 2 2 2 2 2 50 6 6 6 6 6 6 6
6 6 6 6 6 6 6 49 2 2 2 2 2 66 60 2 4 4 4 4 2 4 4 4 2 1 1 1 1 2 4 4 2 2 2 2 2 2 2 2 2 2 50 6 6 6 6 6 6 6
6 6 6 6 6 6 46 57 44 19 19 19 19 19 45 2 2 2 2 2 2 4 4 4 2 2 2 2 69 2 4 4 2 2 2 58 62 54 2 2 2 2 50 6 6 6 6 6 6 6
6 6 6 6 6 46 57 2 18 10 31 31 31 15 18 2 2 2 2 2 2 2 2 4 4 4 2 70 69 2 2 2 2 2 2 2 50 51 54 2 2 2 50 6 6 6 6 6 6 6
6 6 6 6 6 49 2 2 18 32 44 19 45 26 18 2 2 58 64 2 2 2 2 4 4 4 4 2 1 71 71 71 1 2 68 2 50 46 57 2 2 2 56 48 6 6 6 6 6 6
6 6 6 6 6 49 2 2 18 32 18 8 38 19 40 2 2 2 66 62 54 2 2 2 2 4 4 2 2 2 2 2 2 2 2 2 56 57 2 2 2 2 2 50 6 6 6 6 6 6
6 6 6 6 6 51 54 2 18 32 43 19 42 33 18 2 2 2 2 50 49 2 71 71 2 2 2 2 2 2 2 2 2 2 2 2 2 2 2 2 2 2 2 50 6 6 6 6 6 6
6 6 6 6 6 6 51 54 18 17 31 31 31 16 18 2 2 2 2 50 51 54 2 2 2 2 2 2 2 2 2 2 2 2 2 2 2 2 2 2 2 2 2 50 6 6 6 6 6 6
6 6 6 6 6 6 6 49 43 19 19 19 19 19 42 2 2 2 55 53 6 51 52 52 52 52 52 52 52 52 52 52 52 54 2 2 2 2 2 2 2 2 55 53 6 6 6 6 6 6
6 6 6 6 6 6 6 51 52 52 54 2 2 2 2 2 2 55 53 6 6 6 6 6 6 6 6 6 6 6 6 6 6 51 52 54 2 2 2 2 55 52 53 6 6 6 6 6 6 6
6 6 6 6 6 6 6 6 6 6 51 52 52 52 52 52 52 53 6 6 6 6 6 6 6 6 6 6 6 6 6 6 6 6 6 51 52 52 52 52 53 6 6 6 6 6 6 6 6 6
6 6 6 6 6 6 6 6 6 6 6 6 6 6 6 6 6 6 6 6 6 6 6 6 6 6 6 6 6 6 6 6 6 6 6 6 6 6 6 6 6 6 6 6 6 6 6 6 6 6
6 6 6 6 6 6 6 6 6 6 6 6 6 6 6 6 6 6 6 6 6 6 6 6 6 6 6 6 6 6 6 6 6 6 6 6 6 6 6 6 6 6 6 6 6 6 6 6 6 6
6 6 6 6 6 6 6 6 6 6 6 6 6 6 6 6 6 6 6 6 6 6 6 6 6 6 6 6 6 6 6 6 6 6 6 6 6 6 6 6 6 6 6 6 6 6 6 6 6 6
6 6 6 6 6 6 6 6 6 6 6 6 6 6 6 6 6 6 6 6 6 6 6 6 6 6 6 6 6 6 6 6 6 6 6 6 6 6 6 6 6 6 6 6 6 6 6 6 6 6
6 6 6 6 6 6 6 6 6 6 6 6 6 6 6 6 6 6 6 6 6 6 6 6 6 6 6 6 6 6 6 6 6 6 6 6 6 6 6 6 6 6 6 6 6 6 6 6 6 6
