6 6 6 6 6 6 6 6 6 6 6 6 6 6 6 6 6 6 6 6 6 6 6 6 6 6 6 6 6 6 6 6 6 6 6 6 6 6 6 6 6 6 6 6 6 6 6 6 6 6
6 6 6 6 6 6 6 6 6 6 6 6 6 6 6 6 6 6 6 6 6 6 6 6 6 6 6 6 6 6 6 6 6 6 6 6 6 6 6 6 6 6 6 6 6 6 6 6 6 6
6 6 6 6 6 6 6 6 6 6 6 6 6 6 6 6 6 6 6 6 6 6 6 6 6 6 6 6 6 6 6 6 6 6 6 6 6 6 6 6 6 6 6 6 6 6 6 6 6 6
6 6 6 6 6 6 6 6 6 6 6 6 6 6 6 6 6 6 6 6 6 6 6 6 6 6 6 6 6 6 6 6 6 6 6 6 6 6 6 6 6 6 6 6 6 6 6 6 6 6
6 6 6 6 6 6 6 46 47 47 48 6 6 6 6 6 6 6 6 6 6 6 6 6 6 6 6 6 6 6 6 6 6 6 6 6 47 47 47 47 47 48 6 6 6 6 6 6 6 6
6 6 6 6 6 46 47 57 2 2 56 48 6 6 6 6 6 6 6 6 6 6 6 6 6 6 6 6 6 6 6 6 6 6 6 57 2 2 2 2 2 56 47 48 6 6 6 6 6 6
6 6 6 6 6 57 2 2 2 2 2 56 47 47 47 47 47 47 47 47 47 47 47 47 47 47 47 47 47 47 47 47 47 47 57 2 1 1 2 2 2 2 2 56 48 6 6 6 6 6
6 6 6 6 49 2 2 2 2 2 2 2 2 2 2 2 2 2 2 2 2 2 2 2 2 2 2 2 2 2 2 2 2 2 2 2 1 2 2 4 4 4 2 2 56 48 6 6 6 6
6 6 6 6 49 2 2 2 2 2 1 1 1 1 2 2 2 2 2 2 2 2 2 2 2 2 2 2 2 2 2 2 2 2 2 2 2 2 4 4 4 4 4 4 2 50 6 6 6 6
6 6 6 6 49 2 2 2 2 1 1 2 2 2 2 2 2 2 2 2 2 2 2 2 2 2 2 2 2 4 4 4 4 4 4 4 4 4 4 4 4 4 4 2 2 50 6 6 6 6
6 6 6 6 49 2 2 2 1 1 2 2 2 2 2 2 2 4 4 4 4 4 4 4 4 4 4 4 4 4 4 4 4 4 4 4 4 4 4 4 4 2 2 2 2 50 6 6 6 6
6 6 6 6 49 2 2 1 1 2 2 2 4 2 2 2 4 4 4 4 4 4 4 4 4 4 4 4 4 4 2 2 2 4 4 4 4 4 4 2 2 2 1 2 55 53 6 6 6 6
6 6 6 6 49 2 1 1 1 2 2 4 4 4 2 4 4 4 4 4 4 4 4 4 4 4 4 4 4 4 2 4 2 4 2 2 9 4 4 2 1 1 2 55 53 6 6 6 6 6
6 6 6 6 51 54 2 2 2 2 2 4 4 4 2 4 4 4 4 2 2 2 2 2 2 2 2 4 4 2 2 4 2 4 2 4 4 4 4 2 1 1 55 53 6 6 6 6 6 6
6 6 6 6 6 51 52 54 2 2 2 4 4 4 2 4 4 4 4 4 4 4 4 4 4 4 2 4 4 2 4 4 2 4 2 4 4 4 4 2 1 1 50 6 6 6 6 6 6 6
6 6 6 6 6 6 46 57 2 2 2 2 4 2 2 4 4 4 4 4 4 4 4 4 4 4 2 4 4 2 4 2 2 4 2 2 2 2 4 2 2 1 50 6 6 6 6 6 6 6
6 6 6 6 6 46 57 2 2 2 2 2 2 2 4 4 4 4 4 4 4 4 4 4 4 4 2 4 4 2 4 2 4 4 4 4 4 2 4 4 2 1 50 6 6 6 6 6 6 6
6 6 6 6 6 49 2 2 2 2 2 4 4 4 4 4 4 2 2 2 2 2 2 2 2 2 2 2 4 2 4 2 4 2 2 2 4 2 4 4 2 1 56 48 6 6 6 6 6 6
6 6 6 6 6 49 2 2 2 2 4 4 4 4 4 2 2 2 4 4 4 4 4 4 4 2 2 2 2 2 4 2 4 2 4 2 2 2 4 4 2 1 2 50 6 6 6 6 6 6
6 6 6 6 6 49 2 2 2 2 4 2 2 2 4 2 4 4 4 4 4 4 4 4 4 4 4 2 4 4 4 2 2 2 4 4 4 4 4 4 2 1 2 56 48 6 6 6 6 6
6 6 6 6 6 49 2 4 4 2 4 2 4 2 4 2 2 2 4 4 4 4 4 4 4 2 2 2 4 4 4 4 4 4 4 4 4 4 4 4 2 1 2 2 50 6 6 6 6 6
6 6 6 6 6 49 2 4 4 2 2 2 4 2 4 2 2 2 2 2 2 2 2 2 2 2 2 2 2 2 2 2 2 2 2 2 2 2 4 4 2 2 1 2 50 6 6 6 6 6
6 6 6 6 6 49 2 4 4 4 4 4 4 2 2 2 1 1 1 1 1 1 1 1 1 1 1 1 1 1 1 1 1 1 1 1 1 2 4 4 4 2 2 2 50 6 6 6 6 6
6 6 6 6 6 49 2 4 4 4 4 4 4 2 2 2 1 1 1 1 1 1 1 1 1 1 1 1 1 1 1 1 1 1 1 1 1 2 4 4 4 2 2 2 50 6 6 6 6 6
6 6 6 6 6 49 2 4 4 4 4 2 2 2 2 2 2 2 2 2 2 2 2 2 1 1 1 1 2 2 2 2 2 2 2 2 2 2 4 4 4 2 1 2 50 6 6 6 6 6
6 6 6 6 6 49 2 4 4 4 4 2 4 4 4 4 4 4 4 4 4 4 4 2 2 1 1 2 2 4 4 4 4 4 4 4 4 4 4 4 2 2 1 2 50 6 6 6 6 6
6 6 6 6 6 49 2 4 4 4 4 2 4 2 2 2 2 2 2 2 2 4 4 4 2 1 1 2 2 2 2 2 2 2 2 2 2 2 2 4 2 2 2 55 53 6 6 6 6 6
6 6 6 6 6 49 2 4 4 4 4 2 4 2 2 2 2 2 2 2 2 4 4 4 2 1 1 2 4 4 4 4 4 4 4 4 4 4 2 4 2 2 2 50 6 6 6 6 6 6
6 6 6 6 6 49 2 4 4 4 4 2 4 2 2 2 2 2 2 2 2 4 4 4 2 1 1 2 4 4 2 2 2 2 2 2 2 4 2 4 2 2 2 50 6 6 6 6 6 6
6 6 6 6 6 49 2 2 4 4 4 2 2 2 2 2 2 2 2 2 4 4 4 4 2 1 1 2 4 4 2 4 4 4 4 4 2 4 2 4 2 2 2 50 6 6 6 6 6 6
6 6 6 6 6 51 54 2 4 4 4 4 4 4 4 4 4 4 4 2 4 4 4 4 2 1 1 2 4 4 2 4 2 2 2 2 2 4 2 4 2 2 2 50 6 6 6 6 6 6
6 6 6 6 6 6 49 2 4 4 4 4 4 4 4 4 4 4 4 2 2 2 4 4 2 1 1 2 4 4 2 4 4 4 4 4 4 4 2 4 2 2 55 53 6 6 6 6 6 6
6 6 6 6 6 6 49 2 2 2 2 2 4 4 4 4 4 4 4 4 4 2 4 4 2 1 1 2 4 4 2 2 2 2 2 2 2 2 2 4 2 2 50 6 6 6 6 6 6 6
6 6 6 6 6 6 51 52 52 52 54 2 2 2 2 4 4 4 2 2 2 2 4 4 2 1 1 2 4 4 4 4 4 4 4 4 4 4 4 2 2 2 50 6 6 6 6 6 6 6
6 6 6 6 6 6 6 49 20 21 51 52 52 54 2 2 2 2 2 4 4 4 4 4 2 1 1 2 2 2 4 4 4 2 2 2 2 2 2 2 2 2 50 6 6 6 6 6 6 6
6 6 6 6 6 6 6 49 34 1 35 35 21 51 54 2 4 4 4 4 2 4 4 4 2 1 1 1 1 2 4 4 2 2 2 2 2 2 2 2 2 2 50 6 6 6 6 6 6 6
6 6 6 6 6 6 6 57 38 37 37 37 41 19 45 2 2 2 2 2 2 4 4 4 2 2 2 2 1 2 4 4 2 2 2 55 52 54 2 2 2 2 50 6 6 6 6 6 6 6
6 6 6 6 6 6 57 20 36 5 5 5 5 5 18 2 2 2 2 2 2 2 2 4 4 4 2 2 1 2 2 2 2 2 55 53 6 51 54 2 2 2 50 6 6 6 6 6 6 6
6 6 6 6 6 49 20 1 36 5 44 19 45 5 18 2 2 55 54 2 2 2 2 4 4 4 4 2 1 1 1 1 2 2 56 48 6 46 57 2 2 2 56 48 6 6 6 6 6 6
6 6 6 6 6 49 23 1 36 5 18 8 38 19 40 2 2 2 56 52 54 2 2 2 2 4 4 2 2 2 2 2 2 2 2 56 47 57 2 2 2 2 2 50 6 6 6 6 6 6
6 6 6 6 6 51 54 23 36 5 43 19 42 5 18 2 2 1 2 50 49 2 1 1 2 2 2 2 2 2 2 2 2 2 2 2 2 2 2 2 2 2 2 50 6 6 6 6 6 6
6 6 6 6 6 6 51 54 18 5 5 5 5 5 18 2 2 1 2 50 51 54 2 2 2 2 2 2 2 2 2 2 2 2 2 2 2 2 2 2 2 2 2 50 6 6 6 6 6 6
6 6 6 6 6 6 6 49 43 19 19 19 19 19 1 1 2 2 55 53 6 51 52 52 52 52 52 52 52 52 52 52 52 54 2 2 2 2 2 2 2 2 55 53 6 6 6 6 6 6
6 6 6 6 6 6 6 51 52 52 54 2 2 2 2 2 2 55 53 6 6 6 6 6 6 6 6 6 6 6 6 6 6 51 52 54 2 2 2 2 55 52 53 6 6 6 6 6 6 6
6 6 6 6 6 6 6 6 6 6 51 52 52 52 52 52 52 53 6 6 6 6 6 6 6 6 6 6 6 6 6 6 6 6 6 51 52 52 52 52 53 6 6 6 6 6 6 6 6 6
6 6 6 6 6 6 6 6 6 6 6 6 6 6 6 6 6 6 6 6 6 6 6 6 6 6 6 6 6 6 6 6 6 6 6 6 6 6 6 6 6 6 6 6 6 6 6 6 6 6
6 6 6 6 6 6 6 6 6 6 6 6 6 6 6 6 6 6 6 6 6 6 6 6 6 6 6 6 6 6 6 6 6 6 6 6 6 6 6 6 6 6 6 6 6 6 6 6 6 6
6 6 6 6 6 6 6 6 6 6 6 6 6 6 6 6 6 6 6 6 6 6 6 6 6 6 6 6 6 6 6 6 6 6 6 6 6 6 6 6 6 6 6 6 6 6 6 6 6 6
6 6 6 6 6 6 6 6 6 6 6 6 6 6 6 6 6 6 6 6 6 6 6 6 6 6 6 6 6 6 6 6 6 6 6 6 6 6 6 6 6 6 6 6 6 6 6 6 6 6
6 6 6 6 6 6 6 6 6 6 6 6 6 6 6 6 6 6 6 6 6 6 6 6 6 6 6 6 6 6 6 6 6 6 6 6 6 6 6 6 6 6 6 6 6 6 6 6 6 6
