10 10 10 10 10 10 10 10 10 10 10 10 10 10 10 10 10 10 10 10 10 10 10 10 10 10 10 10 10 10 10 10 10 10 10 10 10 10 10 10 10 10 10 10 10 10 10 10 10 10 
10 10 10 10 10 10 10 10 10 10 10 10 10 10 10 10 10 10 10 10 10 10 10 10 10 10 10 10 10 10 10 10 10 10 10 10 10 10 10 10 10 10 10 10 10 10 10 10 10 10 
10 10 10 10 10 10 10 10 10 10 10 10 10 10 10 10 10 10 10 10 10 10 10 10 10 10 10 10 10 10 10 10 10 10 10 10 10 10 10 10 10 10 10 10 10 10 10 10 10 10 
10 10 10 10 10 10 10 10 10 10 10 10 10 10 10 10 10 10 10 10 10 10 10 10 10 10 10 10 10 10 10 10 10 10 10 10 10 10 10 10 10 10 10 10 10 10 10 10 10 10 
10 10 10 10 10 10 10 10 10 10 10 10 10 10 10 10 10 10 10 10 10 10 10 10 10 10 10 10 10 10 10 10 10 10 10 10 10 10 10 10 10 10 10 10 10 10 10 10 10 10 
10 10 10 10 10 10 10 10 10 10 10 10 9 9 9 9 9 10 10 9 9 9 9 9 9 9 9 9 9 9 9 9 9 9 9 9 9 9 9 9 9 9 10 10 10 10 10 10 10 10 
10 10 10 10 10 10 10 10 10 9 9 9 9 3 3 3 9 9 9 9 3 7 7 7 7 7 7 3 3 3 3 3 3 3 3 3 3 3 3 7 3 9 10 10 10 10 10 10 10 10 
10 10 10 10 10 10 10 10 10 9 3 3 3 3 3 3 3 3 3 3 3 7 7 3 3 3 3 3 3 3 3 6 3 3 7 7 7 3 3 7 3 9 10 10 10 10 10 10 10 10 
10 10 10 10 10 10 10 10 10 9 3 3 3 3 3 7 3 7 7 7 3 3 3 3 6 6 6 6 6 6 6 6 3 3 3 3 7 7 3 7 3 9 10 10 10 10 10 10 10 10 
10 10 10 10 10 10 10 10 10 9 3 3 7 3 3 7 7 7 3 3 3 3 6 6 6 6 6 6 6 6 6 6 6 6 6 6 3 7 3 3 3 9 10 10 10 10 10 10 10 10 
10 10 10 10 10 10 10 10 10 9 3 3 7 3 3 7 7 7 3 3 6 6 6 6 10 10 10 10 10 10 10 10 6 6 6 6 3 7 3 9 9 9 10 10 10 10 10 10 10 10 
10 10 10 10 10 10 10 10 10 9 3 7 7 3 3 3 3 3 3 3 6 6 6 10 10 10 10 10 10 10 10 10 6 6 6 3 3 3 3 9 10 10 10 10 10 10 10 10 10 10 
10 10 10 10 10 10 10 10 10 9 3 7 7 7 3 3 2 3 3 3 6 6 10 10 10 10 10 10 10 10 10 10 10 6 6 3 3 7 3 9 10 10 10 10 10 10 10 10 10 10 
10 10 10 10 10 10 10 10 10 9 3 7 7 7 3 3 2 2 6 6 6 6 10 10 10 10 10 10 10 10 10 10 10 6 6 6 3 7 7 9 10 10 10 10 10 10 10 10 10 10 
10 10 10 10 10 10 10 10 10 9 3 7 7 7 3 3 3 3 3 6 6 6 10 10 10 10 10 10 10 10 10 10 10 6 6 6 3 3 7 9 10 10 10 10 10 10 10 10 10 10 
10 10 10 10 10 10 10 10 9 9 3 7 7 7 3 3 3 2 6 6 6 6 10 10 10 10 10 10 10 10 10 10 10 6 6 6 3 3 7 9 9 10 10 10 10 10 10 10 10 10 
10 10 10 10 10 10 10 10 9 3 3 3 3 3 3 3 3 2 3 3 6 6 6 10 10 10 10 10 10 10 10 10 10 6 6 6 3 3 3 3 9 10 10 10 10 10 10 10 10 10 
10 10 10 10 10 10 10 10 9 9 3 3 2 2 2 2 3 3 3 3 6 6 6 6 10 10 10 10 10 10 10 10 10 6 6 3 3 7 3 3 9 10 10 10 10 10 10 10 10 10 
10 10 10 10 10 10 10 10 10 9 2 3 3 3 2 3 3 7 7 3 3 6 6 6 10 10 10 10 10 10 10 10 10 6 6 3 3 7 7 7 7 10 10 10 10 10 10 10 10 10 
10 10 10 10 10 10 10 10 9 9 2 2 2 2 2 3 7 7 3 7 3 6 6 6 10 10 10 10 10 10 10 10 6 6 6 6 3 7 7 3 9 10 10 10 10 10 10 10 10 10 
10 10 10 10 10 10 10 10 9 2 2 2 2 2 2 3 7 7 3 7 3 3 6 6 6 6 6 6 6 6 6 6 6 6 6 3 3 7 7 3 9 10 10 10 10 10 10 10 10 10 
10 10 10 10 10 10 10 10 9 6 2 2 2 2 3 3 3 3 3 7 7 7 3 6 6 6 6 6 6 6 6 6 6 3 3 3 3 3 3 3 9 10 10 10 10 10 10 10 10 10 
10 10 10 10 10 10 10 10 9 6 3 3 3 3 3 3 7 7 3 3 3 7 3 3 3 3 3 3 3 3 3 3 3 3 3 3 3 3 3 3 9 9 9 9 9 10 10 10 10 10 
10 10 10 10 10 10 10 10 9 6 3 7 7 3 3 3 7 7 7 3 3 3 3 3 3 3 3 3 3 3 3 3 3 7 7 7 3 3 3 3 3 3 3 3 9 10 10 10 10 10 
10 10 10 10 10 10 10 10 9 6 3 7 7 7 7 3 3 7 7 7 7 7 7 7 7 3 3 7 7 7 7 7 7 7 7 7 3 3 7 7 7 7 3 3 9 10 10 10 10 10 
10 10 10 10 10 10 10 10 9 6 3 3 3 3 7 7 7 3 3 3 3 3 3 3 3 3 3 3 3 3 3 3 3 3 3 3 3 3 7 7 7 7 3 3 9 10 10 10 10 10 
10 10 10 10 10 10 10 10 9 6 3 7 7 7 7 3 3 3 3 7 7 3 3 3 3 3 7 3 3 3 7 7 7 7 7 7 7 7 7 3 7 3 3 3 9 10 10 10 10 10 
10 10 10 10 10 10 10 10 9 6 3 7 3 3 3 3 3 3 3 3 3 3 7 7 3 3 7 3 3 7 7 7 7 3 3 7 7 3 7 7 7 3 3 3 9 10 10 10 10 10 
10 10 10 10 10 10 10 10 9 6 3 3 3 6 6 6 6 6 6 6 3 3 7 7 3 3 7 3 3 3 3 3 3 3 3 7 3 7 3 3 3 3 3 3 9 10 10 10 10 10 
10 10 10 10 10 10 10 10 9 6 6 3 6 6 9 9 9 9 9 6 6 3 7 7 7 7 7 3 7 7 7 7 7 7 7 7 3 7 3 3 3 3 3 3 9 10 10 10 10 10 
10 10 10 10 10 10 10 10 9 6 6 6 6 9 9 2 2 2 9 9 6 3 7 7 7 7 3 3 7 7 7 7 7 7 3 3 3 3 7 7 7 7 3 3 9 10 10 10 10 10 
10 10 10 10 10 10 9 9 9 6 6 6 6 9 2 2 2 2 2 9 6 3 7 7 7 7 7 3 3 3 3 3 3 7 7 7 3 3 7 3 3 3 3 9 9 10 10 10 10 10 
10 10 10 10 10 10 9 6 6 6 6 6 9 9 2 2 2 2 2 9 6 3 3 7 3 3 3 3 3 3 3 3 3 3 3 7 7 3 7 3 7 3 3 9 10 10 10 10 10 10 
10 10 10 10 10 10 9 6 6 6 6 6 2 2 2 2 2 2 2 9 6 3 3 7 3 7 7 3 7 7 7 3 7 7 3 3 7 3 3 3 7 7 3 9 10 10 10 10 10 10 
10 10 10 10 10 10 9 6 6 6 6 6 2 2 2 2 2 2 2 9 6 3 3 7 3 7 7 3 3 7 3 3 7 7 7 3 7 3 3 3 7 7 3 9 10 10 10 10 10 10 
10 10 10 10 10 10 9 9 9 9 9 9 9 9 9 9 9 9 9 9 6 6 3 7 3 3 3 3 3 3 3 3 3 3 7 3 3 3 3 3 3 3 3 9 10 10 10 10 10 10 
10 10 10 10 10 10 10 10 10 10 10 9 6 6 6 6 6 6 6 6 6 6 3 3 3 3 3 3 3 7 3 3 7 3 7 3 3 3 3 7 3 3 3 9 10 10 10 10 10 10 
10 10 10 10 10 10 10 10 10 10 10 9 6 3 3 3 3 3 3 3 3 3 3 3 3 3 3 3 3 7 7 3 7 3 3 3 3 3 7 7 7 3 3 9 10 10 10 10 10 10 
10 10 10 10 10 10 10 10 9 9 9 9 6 3 7 7 7 7 7 3 7 7 7 7 3 3 3 3 3 3 7 3 7 7 7 3 3 3 7 7 7 7 3 9 10 10 10 10 10 10 
10 10 10 10 10 10 10 10 9 3 3 3 3 3 7 7 7 3 3 3 7 7 7 7 3 3 3 3 3 3 7 3 3 3 3 3 3 3 7 7 3 7 3 9 10 10 10 10 10 10 
10 10 10 10 10 10 10 10 9 3 3 7 7 3 3 3 7 7 3 3 7 7 7 7 7 3 3 3 7 3 7 3 7 7 3 3 3 3 7 7 3 7 3 9 10 10 10 10 10 10 
10 10 10 10 10 10 10 10 9 3 3 3 7 7 7 7 7 3 7 3 3 7 7 7 3 3 3 7 7 7 3 3 3 3 3 3 3 3 3 7 3 7 7 9 10 10 10 10 10 10 
10 10 10 10 10 10 10 10 9 9 3 3 3 3 3 7 7 3 7 3 3 3 7 7 3 3 3 3 3 3 3 3 7 3 7 3 3 7 3 3 3 7 3 9 10 10 10 10 10 10 
10 10 10 10 10 10 10 10 10 9 9 9 9 3 3 3 7 3 7 3 7 7 7 3 3 3 3 7 7 7 3 7 7 3 7 3 3 7 7 7 3 3 3 9 10 10 10 10 10 10 
10 10 10 10 10 10 10 10 10 10 10 10 9 3 4 3 7 3 3 3 7 3 7 3 9 9 9 3 3 7 3 3 3 3 3 3 3 3 3 7 7 3 3 9 10 10 10 10 10 10 
10 10 10 10 10 10 10 10 10 10 10 10 9 3 3 3 7 7 3 7 3 3 3 3 9 10 9 3 3 3 3 3 3 3 7 9 9 9 9 9 9 3 3 9 10 10 10 10 10 10 
10 10 10 10 10 10 10 10 10 10 10 10 9 3 3 3 3 3 3 3 3 3 7 7 9 10 9 9 3 3 3 3 3 7 7 9 10 10 10 10 9 9 9 9 10 10 10 10 10 10 
10 10 10 10 10 10 10 10 10 10 10 10 9 9 9 9 9 9 9 3 3 3 9 9 9 10 10 9 9 9 9 9 9 9 9 9 10 10 10 10 10 10 10 10 10 10 10 10 10 10 
10 10 10 10 10 10 10 10 10 10 10 10 10 10 10 10 10 10 9 9 9 9 9 10 10 10 10 10 10 10 10 10 10 10 10 10 10 10 10 10 10 10 10 10 10 10 10 10 10 10 
10 10 10 10 10 10 10 10 10 10 10 10 10 10 10 10 10 10 10 10 10 10 10 10 10 10 10 10 10 10 10 10 10 10 10 10 10 10 10 10 10 10 10 10 10 10 10 10 10 10 
