9 9 9 9 9 9 9 9 9 9 9 9 9 9 9 9 9 9 9 9 9 9 9 9 9 9 9 9 9 9 9 9 9 9 9 9 9 9 9 9 9 9 9 9 9 9 9 9 9 9 
9 3 3 3 3 3 3 3 3 3 3 3 3 3 3 3 3 3 3 3 3 3 3 3 3 3 3 3 3 3 3 9 7 3 3 3 3 3 3 3 3 3 3 3 3 3 3 3 3 9 
9 3 3 3 3 3 3 3 3 3 3 3 3 3 3 3 3 3 3 7 7 7 3 3 3 3 3 3 3 3 3 9 7 7 3 3 3 3 3 3 3 3 3 3 3 3 3 3 3 9 
9 3 3 3 3 7 7 3 3 3 7 7 3 3 7 7 3 3 3 7 7 7 7 7 3 3 3 7 3 3 3 9 3 7 3 3 3 3 3 3 3 3 3 7 7 3 3 3 3 9 
9 3 3 3 3 7 7 7 3 3 3 7 7 3 3 3 3 3 3 3 7 3 3 7 7 3 3 7 3 3 3 9 3 7 7 3 3 7 7 7 7 7 7 7 7 7 7 3 3 9 
9 3 3 3 7 7 3 7 7 3 3 3 7 7 3 3 3 3 3 3 7 3 3 3 3 3 7 7 3 3 3 9 3 3 7 3 3 7 3 3 3 3 3 3 3 3 7 3 3 9 
9 3 3 3 7 3 3 3 7 7 3 3 3 7 7 3 3 3 3 3 7 7 7 3 3 7 7 3 3 3 9 9 3 3 7 3 3 7 3 3 3 7 7 7 7 7 7 3 3 9 
9 9 3 3 7 7 3 3 3 7 7 3 3 3 7 7 3 3 3 3 3 3 7 7 7 7 3 3 3 3 9 3 3 7 7 3 3 7 3 3 3 7 3 3 3 3 3 3 3 9 
9 9 3 3 3 3 3 3 3 3 3 3 3 3 3 3 3 3 3 3 3 3 3 3 3 3 3 3 3 3 9 3 3 7 7 3 3 3 3 3 7 7 3 3 3 3 3 3 3 9 
9 9 3 3 3 3 3 3 3 3 3 3 3 3 3 3 3 3 3 3 3 3 3 3 3 3 3 3 3 3 9 3 3 3 3 3 3 3 3 3 7 3 3 3 3 3 3 3 3 9 
9 9 3 3 3 3 3 3 3 3 3 3 3 3 3 3 3 3 3 3 3 3 3 3 3 3 3 3 3 3 9 3 3 3 3 3 3 3 7 3 7 3 7 3 3 3 3 3 3 9 
9 3 7 3 3 3 3 3 3 3 3 3 3 7 7 3 7 7 7 3 7 3 3 3 3 7 7 3 3 3 9 9 3 3 7 3 3 3 7 3 3 7 7 3 3 3 7 7 3 9 
9 3 7 7 7 3 3 7 3 7 7 7 7 7 7 3 7 7 7 3 7 3 3 7 7 7 7 7 7 7 7 3 3 2 7 7 2 2 7 7 2 7 2 2 2 7 7 7 3 9 
9 3 7 7 7 3 7 7 3 7 7 7 7 7 7 3 3 3 3 7 7 3 3 3 3 3 7 3 3 3 7 7 3 3 3 7 7 3 3 7 3 7 3 3 3 7 3 7 3 9 
9 3 7 3 3 3 7 7 3 7 7 7 7 7 7 3 3 3 3 7 3 3 3 3 3 3 7 7 3 3 7 7 3 3 3 3 7 7 3 3 3 7 3 3 7 3 3 7 3 9 
9 3 3 3 7 7 3 3 3 7 7 3 3 3 3 3 3 3 7 7 3 3 3 3 3 3 3 3 7 3 3 3 3 3 3 3 3 7 7 3 3 7 3 7 7 3 3 7 7 9 
9 3 7 3 7 7 3 7 7 7 7 7 7 7 3 7 3 3 7 3 3 3 3 7 7 3 3 3 3 3 3 3 3 3 3 3 3 3 7 3 3 3 3 7 3 3 3 3 7 9 
9 3 7 3 7 7 3 7 7 7 7 7 7 7 3 3 3 3 3 3 3 3 3 7 7 7 3 3 3 3 3 3 3 3 3 3 3 3 7 7 3 3 7 7 3 3 7 3 7 9 
9 3 7 3 3 7 3 3 3 3 3 3 3 3 3 3 3 3 3 3 3 7 7 7 3 7 7 7 3 3 3 3 3 3 3 3 3 3 3 7 7 7 7 3 3 7 7 3 3 9 
9 3 3 3 3 3 3 3 3 3 3 3 3 3 3 3 3 3 3 3 7 7 3 3 3 3 3 7 7 7 7 7 7 7 7 3 3 3 3 3 7 7 3 3 7 7 3 3 3 9 
9 3 3 3 3 3 3 3 3 3 3 3 3 3 3 3 3 3 3 3 3 3 3 3 3 3 3 3 3 3 3 3 3 3 3 3 7 7 7 3 3 3 3 7 7 3 3 3 3 9 
9 3 7 3 3 7 3 3 3 7 7 3 3 3 3 7 7 7 7 7 3 3 3 3 3 3 3 3 3 3 3 3 3 3 3 7 7 3 7 3 3 3 7 7 7 7 7 7 3 9 
9 3 7 3 3 7 3 3 7 7 7 7 3 3 3 7 3 3 3 7 3 3 3 3 3 3 3 3 3 3 3 7 7 7 7 7 3 3 3 3 3 3 7 7 7 7 3 3 3 9 
9 3 7 3 3 7 3 7 7 3 3 7 3 3 3 7 7 3 3 7 3 3 3 3 3 3 7 7 7 3 3 3 7 7 3 3 3 3 3 3 3 3 7 7 7 7 3 3 3 9 
9 3 7 3 3 7 3 7 3 3 3 7 3 3 3 3 7 7 3 7 7 3 3 3 3 7 7 3 7 7 3 3 3 3 3 3 7 7 7 7 7 3 3 3 3 3 3 3 3 9 
9 3 7 3 3 7 3 7 3 3 3 7 7 7 3 3 3 3 3 3 7 3 3 3 7 7 3 3 3 7 7 3 3 3 7 7 7 3 3 3 7 7 7 7 7 3 3 3 3 9 
9 3 7 3 3 7 3 7 7 3 3 3 3 7 7 7 7 3 3 3 7 3 3 3 3 3 3 3 3 3 7 7 7 7 7 3 3 3 3 3 3 3 3 3 3 3 3 3 3 9 
9 3 7 7 3 7 3 3 3 7 7 3 3 3 3 3 3 3 3 3 7 3 3 3 3 3 3 3 3 3 3 3 3 3 3 3 3 3 3 3 3 3 3 3 3 3 3 3 3 9 
9 3 3 7 3 7 7 3 3 3 3 3 3 3 3 3 3 3 3 3 7 3 3 3 3 3 3 3 3 3 3 3 3 3 3 3 3 3 3 3 3 3 3 3 3 3 3 3 3 9 
9 3 3 7 3 3 7 7 7 7 7 7 7 7 3 3 3 3 3 3 7 3 3 7 7 7 3 3 3 3 3 3 3 3 3 3 3 3 3 3 3 3 3 3 3 3 3 3 3 9 
9 3 3 7 3 3 3 3 3 3 3 3 3 7 7 7 7 3 3 3 7 3 3 7 7 7 7 3 3 3 3 3 3 3 3 3 3 3 3 3 3 3 3 3 3 3 3 3 3 9 
9 3 7 7 7 7 7 7 7 7 7 7 3 3 3 3 7 3 3 3 3 3 3 7 7 7 7 7 3 3 3 3 7 7 7 7 7 7 7 7 7 7 7 7 7 7 3 3 3 9 
9 3 3 3 3 3 3 3 3 3 3 3 3 3 3 3 3 3 3 3 3 3 7 7 7 7 7 7 3 3 3 7 7 3 3 3 3 3 3 3 3 3 3 3 3 7 3 3 3 9 
9 3 3 9 9 9 9 9 9 9 9 9 9 9 9 9 9 9 3 3 3 3 3 7 7 7 7 7 3 3 3 3 3 3 3 3 3 3 7 7 3 3 3 3 3 7 3 3 3 9 
9 9 9 9 9 9 9 9 9 9 9 9 9 9 9 9 9 3 3 3 3 3 3 3 3 3 3 3 3 3 3 3 3 3 3 3 3 3 7 7 7 7 7 3 3 7 3 3 3 9 
9 3 3 3 3 3 3 3 3 3 3 3 3 3 3 3 3 3 3 3 3 3 3 9 9 9 9 9 3 3 3 3 3 3 3 3 3 3 7 3 3 3 3 7 7 7 3 3 3 9 
9 3 3 3 3 3 3 3 3 3 3 3 3 3 3 3 3 3 3 3 3 3 3 3 3 3 3 9 9 9 9 9 9 9 3 3 3 3 7 7 7 7 7 7 7 7 3 3 3 9 
9 3 3 3 3 3 3 3 3 3 3 3 3 3 3 3 3 3 3 3 3 3 3 3 3 9 9 9 9 9 9 9 9 9 3 3 3 3 3 3 3 3 3 3 3 7 7 7 3 9 
9 3 3 3 3 3 3 3 3 3 3 3 3 3 3 3 3 3 3 3 3 3 3 3 3 3 3 3 9 9 9 9 9 9 9 9 3 3 3 3 3 3 3 3 3 3 3 3 3 9 
9 6 6 9 9 9 9 3 3 3 3 3 3 3 3 3 3 3 3 3 3 3 3 3 3 3 3 3 3 3 9 9 9 9 9 9 9 3 3 3 3 3 3 3 3 3 3 3 3 9 
9 6 6 6 6 6 9 3 3 3 3 3 3 3 3 3 3 3 3 3 3 3 3 3 3 3 3 3 3 3 9 9 9 9 9 9 9 9 3 3 3 3 3 3 3 3 3 3 3 9 
9 6 2 2 2 6 9 3 3 3 7 7 7 7 3 3 3 3 3 3 3 3 3 3 3 3 3 3 3 3 3 3 3 3 3 3 3 3 3 3 3 3 3 3 3 3 3 3 3 9 
9 6 2 2 2 6 9 3 3 3 7 3 3 3 3 3 3 3 3 3 3 3 3 3 3 3 3 3 3 3 3 3 3 3 3 3 3 3 3 3 3 3 3 3 3 3 3 3 3 9 
9 6 2 2 2 6 9 6 9 3 7 3 2 3 3 3 7 3 3 3 3 3 3 3 3 3 3 3 3 7 7 7 7 7 7 7 7 7 3 3 3 3 3 3 3 3 3 3 3 9 
9 6 6 6 6 6 9 6 9 6 7 3 3 3 4 3 7 3 3 3 3 3 3 3 3 3 3 3 3 3 3 3 3 3 3 3 3 7 3 3 3 3 3 3 3 3 3 3 3 9 
9 9 9 9 9 9 9 9 9 3 7 3 3 3 3 3 7 3 3 3 3 3 3 3 3 7 7 7 7 7 7 7 7 7 7 7 7 7 3 3 3 3 3 3 3 3 3 3 3 9 
9 3 3 3 3 3 3 3 3 3 7 7 7 7 7 7 7 3 3 3 3 3 3 3 3 3 3 3 3 3 3 3 3 3 3 3 3 3 3 3 3 3 3 3 3 3 3 3 3 9 
9 3 3 3 3 3 3 3 3 3 3 3 3 3 3 3 3 3 3 3 3 3 3 3 3 3 3 3 3 3 3 3 3 3 3 3 3 3 3 3 3 3 3 3 3 3 3 3 3 9 
9 3 3 3 3 3 3 3 3 3 3 3 3 3 3 3 3 3 3 3 3 3 3 3 3 3 3 3 3 3 3 3 3 3 3 3 3 3 3 3 3 3 3 3 3 3 3 3 9 9 
9 9 9 9 9 9 9 9 9 9 9 9 9 9 9 9 9 9 9 9 9 9 9 9 9 9 9 9 9 9 9 9 9 9 9 9 9 9 9 9 9 9 9 9 9 9 9 9 9 9 
