10 10 10 10 10 10 10 10 10 10 10 10 10 10 10 10 10 10 10 10 10 10 10 10 10 10 10 10 10 10 10 10 10 10 10 10 10 10 10 10 10 10 10 10 10 10 10 10 10 10 
10 7 7 7 7 1 1 7 7 7 7 7 7 7 7 7 7 1 1 1 1 1 1 1 1 1 1 1 1 1 1 1 1 1 1 1 1 1 1 1 1 1 1 1 4 4 10 10 10 10 
10 7 7 7 7 1 1 1 1 1 1 1 1 1 1 7 7 1 1 7 7 1 1 1 1 1 1 1 1 1 1 1 1 1 1 1 1 1 1 1 1 1 1 1 4 4 4 4 10 10 
10 7 7 7 1 1 1 1 7 7 7 7 7 1 1 7 7 1 1 1 7 1 1 7 7 7 7 1 1 1 1 1 1 1 1 1 1 1 1 1 1 1 1 1 4 4 4 4 10 10 
10 7 7 1 0 1 1 1 7 7 1 1 7 7 7 7 7 1 1 1 7 7 7 7 1 7 7 1 1 1 1 1 1 1 1 1 1 1 1 1 1 1 1 1 1 4 4 4 10 10 
10 7 7 1 0 0 1 1 1 7 7 7 1 1 1 1 1 1 1 1 7 7 1 7 7 7 1 1 1 1 1 1 1 1 1 1 1 1 1 1 1 1 1 1 1 1 4 4 4 10 
10 7 7 1 1 0 0 0 1 1 1 7 7 7 7 7 7 1 1 1 1 1 1 1 1 1 1 1 1 1 1 1 1 1 1 1 1 1 1 1 1 1 1 1 1 1 1 4 4 10 
10 1 7 1 0 0 0 1 1 0 0 1 1 1 1 1 1 1 1 1 1 1 1 1 1 1 1 7 7 1 1 7 1 7 1 1 1 1 1 1 1 1 1 1 1 1 1 1 4 10 
10 1 7 7 7 0 1 1 1 1 1 0 0 0 0 0 0 0 1 1 1 1 1 1 1 1 7 7 7 7 7 7 1 7 1 1 1 1 1 1 1 1 1 1 1 1 1 1 4 10 
10 1 1 1 1 1 1 1 1 1 1 1 1 1 1 1 1 1 1 1 10 1 1 1 7 7 7 7 7 7 7 7 7 7 1 1 1 1 1 1 1 1 1 1 1 1 1 1 1 10 
10 1 1 1 1 1 1 1 1 1 1 1 1 1 1 1 1 1 1 1 10 1 1 7 7 7 7 7 7 7 7 7 7 1 1 1 1 1 1 1 1 1 1 1 1 1 1 1 1 10 
10 1 1 1 1 1 1 1 1 1 1 1 1 1 1 1 1 1 1 1 10 1 1 1 1 1 1 1 1 1 1 1 1 1 1 1 1 1 1 1 1 1 1 1 1 1 1 1 1 10 
10 10 10 10 10 10 10 10 10 10 10 10 10 10 10 10 10 1 1 1 10 10 10 10 10 10 10 10 7 1 10 10 10 10 10 10 10 10 10 1 10 10 1 10 10 10 1 1 10 10 
10 1 1 0 1 1 1 0 0 0 0 0 0 0 0 0 0 0 1 1 1 1 1 1 1 1 1 1 1 1 1 1 1 1 1 1 1 1 1 1 1 1 1 1 1 1 1 1 1 10 
10 1 7 1 1 7 1 0 0 0 0 0 0 0 0 0 0 0 0 0 0 0 1 1 1 1 1 1 1 1 1 1 1 1 1 1 1 0 1 1 1 1 1 7 1 1 0 0 1 10 
10 1 7 7 7 7 1 1 1 1 1 1 1 1 1 0 0 0 0 0 0 0 0 0 0 0 0 0 0 0 0 0 0 0 0 1 1 0 1 1 1 1 1 7 7 1 1 1 1 10 
10 1 1 1 1 7 1 1 1 0 0 0 1 1 0 0 0 0 0 0 0 0 0 0 0 0 0 0 0 0 0 0 8 8 8 8 8 1 1 1 7 1 1 7 7 1 1 1 1 10 
10 1 1 1 1 7 1 1 1 1 1 1 1 1 1 0 0 0 0 0 0 0 0 0 0 0 0 0 0 0 0 0 8 10 10 10 8 8 8 1 7 7 1 1 7 7 1 1 1 10 
10 1 1 1 1 1 1 1 1 1 1 1 1 1 1 1 0 0 0 0 0 0 0 0 0 0 0 10 10 10 10 10 10 10 0 10 10 10 8 1 1 1 1 1 1 1 1 1 1 10 
10 1 1 1 1 7 1 1 1 1 1 1 1 1 1 1 8 8 8 8 8 8 8 8 8 8 10 10 0 0 0 0 0 0 0 0 0 8 8 1 7 7 7 1 1 1 1 1 1 10 
10 10 1 1 7 7 7 1 1 1 1 1 1 7 7 1 8 8 8 8 8 8 8 8 8 8 10 10 10 10 10 10 10 10 0 0 10 10 8 1 1 1 7 7 1 1 1 1 1 10 
10 10 1 7 7 7 7 7 1 7 1 7 7 7 7 1 8 8 8 4 4 4 4 8 4 4 4 4 4 4 4 4 4 10 10 10 10 10 8 1 1 1 1 1 1 1 1 1 1 10 
10 10 1 1 1 1 1 1 1 7 1 1 1 1 7 1 1 1 8 8 4 4 4 8 4 4 4 4 4 4 4 4 4 4 4 4 1 1 1 1 1 1 1 1 1 1 1 1 1 10 
10 1 1 7 7 7 7 7 7 7 7 7 7 7 7 1 1 1 8 8 4 4 4 8 4 4 4 4 4 4 4 4 4 4 4 4 4 1 1 1 1 1 1 1 1 1 1 1 1 10 
10 1 1 1 7 7 7 7 7 7 7 7 1 1 1 1 1 1 1 8 8 8 4 4 4 4 4 4 4 4 4 4 4 4 4 4 0 0 0 0 1 1 1 1 1 1 1 1 1 10 
10 1 1 1 1 1 1 1 1 1 1 1 1 1 1 1 1 1 1 1 1 8 8 8 4 4 4 4 4 4 4 4 4 4 4 4 4 4 4 4 0 0 0 0 0 1 0 0 0 10 
10 1 1 1 1 1 1 1 1 1 1 1 8 8 8 8 8 0 0 0 1 1 1 8 8 8 1 1 1 1 4 4 4 4 4 4 4 4 4 4 4 4 4 4 4 1 4 0 0 10 
10 1 1 4 4 4 4 4 1 1 1 1 8 4 4 4 8 0 0 0 1 1 1 1 1 1 1 1 1 1 4 4 4 4 4 4 4 4 4 4 4 4 4 4 4 1 4 0 0 10 
10 1 4 4 4 4 4 4 4 4 4 4 4 4 4 4 4 0 0 0 0 1 8 8 1 1 1 1 1 1 4 8 8 4 4 4 4 4 4 4 4 4 4 4 4 1 4 0 0 10 
10 1 4 4 4 4 4 4 10 10 4 4 4 4 4 4 4 0 0 0 0 0 8 8 1 0 1 1 1 8 8 8 8 8 4 4 4 4 4 4 4 4 4 4 4 1 4 0 0 10 
10 1 10 4 4 10 10 4 10 10 4 10 4 4 4 4 4 0 0 0 0 0 8 8 8 0 8 8 8 8 8 4 4 8 4 4 4 4 4 4 4 4 4 0 0 1 0 0 0 10 
10 1 10 10 10 10 10 10 10 10 10 10 0 0 0 0 0 0 0 0 0 8 8 8 8 0 8 4 4 4 8 4 4 8 8 4 4 4 4 4 4 4 4 0 1 1 1 1 1 10 
10 1 10 10 10 10 10 10 10 10 10 10 0 0 0 0 0 0 0 0 0 0 0 0 0 0 8 8 8 8 8 4 4 4 8 4 4 4 4 4 4 4 4 0 1 1 1 1 1 10 
10 1 4 4 4 4 4 4 4 4 4 4 4 4 4 4 0 0 0 0 8 8 8 8 8 8 8 8 8 8 8 8 8 8 8 4 4 4 4 4 4 4 4 0 1 1 1 1 1 10 
10 1 0 0 0 0 1 1 7 7 7 7 7 8 8 8 8 8 8 8 8 8 8 8 8 8 0 0 8 8 8 8 8 8 0 0 0 0 0 0 0 0 0 0 1 1 1 1 1 10 
10 8 8 8 8 8 1 1 7 7 7 7 7 7 8 4 4 4 8 8 8 8 8 8 8 8 1 8 8 8 8 8 8 8 8 8 1 1 1 1 1 1 1 1 1 1 1 1 1 10 
10 8 8 8 8 8 1 1 7 7 7 7 7 1 8 4 4 4 8 8 8 1 1 1 1 1 1 8 8 8 8 8 8 8 8 8 1 1 1 1 1 1 1 1 1 1 1 1 1 10 
10 0 0 0 0 0 1 1 7 7 7 7 7 7 8 4 4 4 8 8 8 1 1 1 1 1 1 1 1 1 1 1 8 8 8 8 1 1 1 1 1 1 1 1 1 1 1 1 1 10 
10 8 8 8 8 8 8 8 1 7 7 7 7 7 8 4 4 8 8 8 8 1 1 1 1 1 1 1 1 1 1 1 8 8 8 8 1 1 1 1 1 1 1 1 1 1 1 1 1 10 
10 8 10 10 10 10 10 8 1 1 7 1 7 7 8 4 8 8 1 1 1 1 1 1 1 1 1 1 1 1 1 1 1 8 8 8 1 1 1 1 1 1 1 1 1 1 1 1 1 10 
10 8 8 8 8 8 10 8 1 1 1 1 1 7 8 8 8 1 1 1 1 1 1 1 1 1 1 1 1 1 1 1 8 8 8 8 1 1 1 1 1 1 1 1 1 1 1 1 1 10 
10 8 0 0 0 8 10 8 1 1 1 1 1 1 1 1 1 1 1 1 1 7 7 1 1 1 1 1 1 1 1 1 1 1 1 1 1 1 1 1 1 1 1 1 1 1 1 1 1 10 
10 8 0 0 0 8 10 8 8 8 1 1 1 1 1 1 1 1 1 1 1 1 1 1 7 7 7 7 1 1 1 7 1 7 1 7 1 1 1 1 1 1 7 1 1 1 1 1 1 10 
10 8 0 0 8 8 10 8 10 8 1 1 1 10 1 10 1 1 1 1 7 1 7 1 1 1 1 1 1 1 1 7 1 1 7 7 1 1 1 1 7 7 7 1 1 1 1 1 7 10 
10 8 8 8 8 10 10 8 10 8 1 1 1 10 5 10 1 1 1 1 7 7 7 7 7 7 1 1 1 1 7 7 7 1 1 7 1 1 1 1 7 1 7 1 7 7 7 1 7 10 
10 10 10 10 10 10 10 8 10 8 1 1 1 10 10 10 1 1 1 1 7 7 7 7 7 7 1 1 1 1 7 7 7 7 1 7 1 1 1 1 7 1 7 7 1 7 7 1 7 10 
10 8 8 8 8 10 8 8 8 8 1 1 1 1 1 7 7 7 1 1 1 7 7 7 7 7 7 7 7 7 1 1 1 7 1 7 7 1 1 1 7 1 7 7 1 7 7 1 7 10 
10 8 8 8 8 8 8 8 1 1 1 7 7 7 7 7 7 7 1 1 1 1 1 1 7 7 7 7 7 7 7 7 7 7 1 7 7 7 7 7 7 7 7 7 1 1 1 1 7 10 
10 8 8 8 8 10 10 1 7 7 7 7 7 7 7 7 7 7 7 7 7 7 0 0 7 7 7 7 7 7 7 7 7 7 7 7 7 7 7 7 7 7 7 7 7 7 7 7 7 10 
10 10 10 10 10 10 10 10 10 10 10 10 10 10 10 10 10 10 10 10 10 10 10 10 10 10 10 10 10 10 10 10 10 10 10 10 10 10 10 10 10 10 10 10 10 10 10 10 10 10 
