6 6 6 6 6 6 6 6 6 6 6 6 6 6 6 6 6 6 6 6 6 6 6 6 6 6 6 6 6 6 6 6 6 6 6 6 6 6 6 6 6 6 6 6 6 6 6 6 6 6
6 6 6 6 6 6 6 6 6 6 6 6 6 6 6 6 6 6 6 6 6 6 6 6 6 6 6 6 6 6 6 6 6 6 6 6 6 6 6 6 6 6 6 6 6 6 6 6 6 6
6 6 6 6 6 6 6 6 6 6 6 6 6 6 6 6 6 6 6 6 6 6 6 6 6 6 6 6 6 6 6 6 6 6 6 6 6 6 6 6 6 6 6 6 6 6 6 6 6 6
6 6 6 6 6 6 6 6 6 6 6 6 6 6 6 6 6 6 6 6 6 6 6 6 6 6 6 6 6 6 6 6 6 6 6 6 6 6 6 6 6 6 6 6 6 6 6 6 6 6
6 6 6 6 6 6 6 46 47 47 48 6 6 6 6 6 6 6 6 6 6 6 6 6 6 6 6 6 6 6 6 6 6 6 6 46 47 47 47 47 47 48 6 6 6 6 6 6 6 6
6 6 6 6 6 46 47 57 2 2 56 48 6 6 6 6 6 6 6 6 6 6 6 6 6 6 6 6 6 6 6 6 6 6 46 57 2 2 2 2 2 56 47 48 6 6 6 6 6 6
6 6 6 6 46 57 2 2 2 2 2 56 47 47 47 47 47 47 47 47 47 47 47 47 47 47 47 47 47 47 47 47 47 47 57 2 2 2 2 2 2 2 2 56 48 6 6 6 6 6
6 6 6 6 49 2 2 2 2 2 2 2 2 2 2 2 2 2 2 2 2 2 2 2 2 2 2 2 2 2 2 2 2 2 2 2 55 63 60 4 4 4 2 2 56 48 6 6 6 6
6 6 6 6 49 2 74 72 72 75 2 2 2 2 2 2 2 2 2 2 2 2 2 2 2 2 2 2 2 2 2 2 2 2 2 2 56 57 4 4 4 4 4 2 2 50 6 6 6 6
6 6 6 6 49 2 70 1 1 69 2 2 2 2 2 2 2 2 2 2 2 2 2 58 61 61 61 61 60 4 4 4 4 4 4 4 4 4 4 4 4 4 4 2 2 50 6 6 6 6
6 6 6 6 49 2 70 1 1 69 2 2 2 2 2 2 2 4 4 4 4 4 4 4 4 4 4 4 4 4 4 4 4 4 4 4 4 4 4 4 4 2 2 2 2 50 6 6 6 6
6 6 6 6 49 2 70 1 1 69 2 2 4 2 2 2 4 4 4 4 4 4 4 4 4 4 4 4 4 4 2 2 2 4 4 4 4 4 4 2 2 2 2 2 55 53 6 6 6 6
6 6 6 6 49 2 73 71 71 76 2 4 4 4 2 4 4 4 4 4 4 4 4 4 4 4 4 4 4 4 2 4 2 4 2 2 9 4 4 2 2 2 2 55 53 6 6 6 6 6
6 6 6 6 51 54 2 2 2 2 2 4 4 4 2 4 4 4 4 2 2 2 2 2 2 2 2 4 4 2 2 4 2 4 2 4 4 4 4 2 2 2 55 53 6 6 6 6 6 6
6 6 6 6 6 51 52 54 2 2 2 4 4 4 2 4 4 4 4 4 4 4 4 4 4 4 2 4 4 2 4 4 2 4 2 4 4 4 4 2 2 2 50 6 6 6 6 6 6 6
6 6 6 6 6 6 46 57 2 2 2 2 4 2 2 4 4 4 4 4 4 4 4 4 4 4 2 4 4 2 4 2 2 4 2 2 2 2 4 2 2 2 50 6 6 6 6 6 6 6
6 6 6 6 6 46 57 2 2 2 2 2 2 2 4 4 4 4 4 4 4 4 4 4 4 4 2 4 4 2 4 2 4 4 4 4 4 2 4 4 2 2 50 6 6 6 6 6 6 6
6 6 6 6 6 49 2 2 2 2 2 4 4 4 4 4 4 2 2 2 2 2 2 2 2 2 2 2 4 2 4 2 4 2 2 2 4 2 4 4 2 2 56 48 6 6 6 6 6 6
6 6 6 6 6 49 2 2 2 2 4 4 4 4 4 2 2 2 4 4 4 4 4 4 4 2 2 2 2 2 4 2 4 2 4 2 2 2 4 4 2 2 2 50 6 6 6 6 6 6
6 6 6 6 6 49 2 2 2 2 4 2 2 2 4 2 4 4 4 4 4 4 4 4 4 4 4 2 4 4 4 2 2 2 4 4 4 4 4 4 2 2 2 56 48 6 6 6 6 6
6 6 6 6 6 49 2 4 4 2 4 2 4 2 4 2 2 2 4 4 4 4 4 4 4 2 2 2 4 4 4 4 4 4 4 4 4 4 4 4 2 74 72 75 50 6 6 6 6 6
6 6 6 6 6 49 2 4 4 2 2 2 4 2 4 2 2 2 2 2 2 2 2 2 2 2 2 2 2 2 2 2 2 2 2 2 2 2 4 4 2 70 1 69 50 6 6 6 6 6
6 6 6 6 6 49 2 4 4 4 4 4 4 2 2 2 74 72 72 72 72 72 72 72 72 72 72 72 72 72 72 72 72 72 72 72 75 2 4 4 4 70 1 69 50 6 6 6 6 6
6 6 6 6 6 49 2 4 4 4 4 4 4 2 2 2 73 71 71 71 71 71 71 71 109 1 1 108 71 71 71 71 71 71 71 71 76 2 4 4 4 70 1 69 50 6 6 6 6 6
6 6 6 6 6 49 2 4 4 4 4 2 2 2 2 2 2 2 2 2 2 2 2 2 73 109 108 76 2 2 2 2 2 2 2 2 2 2 4 4 4 70 1 69 50 6 6 6 6 6
6 6 6 6 6 49 2 4 4 4 4 2 4 4 4 4 4 4 4 4 4 4 4 2 2 70 69 2 2 4 4 4 4 4 4 4 4 4 4 4 74 106 108 76 50 6 6 6 6 6
6 6 6 6 6 49 2 4 4 4 4 2 4 2 2 2 2 2 2 2 2 4 4 4 2 70 69 2 2 2 2 2 2 2 2 2 2 2 2 4 70 1 69 55 53 6 6 6 6 6
6 6 6 6 6 49 2 4 4 4 4 2 4 2 2 2 2 2 2 2 2 4 4 4 2 70 69 2 4 4 4 4 4 4 4 4 4 4 2 4 70 1 69 50 6 6 6 6 6 6
6 6 6 6 6 49 2 4 4 4 4 2 4 2 2 2 2 2 2 2 2 4 4 4 2 70 69 2 4 4 2 2 2 2 2 2 2 4 2 4 70 1 69 50 6 6 6 6 6 6
6 6 6 6 6 49 2 2 4 4 4 2 2 2 2 2 2 2 2 2 4 4 4 4 2 70 69 2 4 4 2 4 4 4 4 4 2 4 2 4 70 1 69 50 6 6 6 6 6 6
6 6 6 6 6 51 54 2 4 4 4 4 4 4 4 4 4 4 4 2 4 4 4 4 2 70 69 2 4 4 2 4 2 2 2 2 2 4 2 4 70 108 76 50 6 6 6 6 6 6
6 6 6 6 6 6 49 2 4 4 4 4 4 4 4 4 4 4 4 2 2 2 4 4 2 70 69 2 4 4 2 4 4 4 4 4 4 4 2 4 70 69 55 53 6 6 6 6 6 6
6 6 6 6 6 6 49 2 2 2 2 2 4 4 4 4 4 4 4 4 4 2 4 4 2 70 69 2 4 4 2 2 2 2 2 2 2 2 2 4 70 69 50 6 6 6 6 6 6 6
6 6 6 6 6 6 51 63 61 61 64 2 2 4 4 4 4 4 2 2 2 2 4 4 2 70 69 2 4 4 4 4 4 4 4 4 4 4 4 2 70 69 50 6 6 6 6 6 6 6
6 6 6 6 6 6 6 49 2 2 66 61 61 64 4 2 2 2 2 4 4 4 4 4 2 70 69 2 2 2 4 4 4 2 2 2 2 2 2 2 70 69 50 6 6 6 6 6 6 6
6 6 6 6 6 6 6 49 2 2 2 2 2 66 60 2 4 4 4 4 2 4 4 4 2 73 112 110 75 2 4 4 2 2 2 2 2 2 2 2 70 69 50 6 6 6 6 6 6 6
6 6 6 6 6 6 46 57 90 81 81 81 81 81 91 2 4 2 2 2 2 4 4 4 2 2 2 70 69 2 4 4 2 2 2 58 62 54 2 2 70 69 50 6 6 6 6 6 6 6
6 6 6 6 6 46 57 2 82 10 31 31 31 15 84 2 2 4 4 2 2 2 2 4 4 4 2 73 115 2 2 2 2 2 2 2 50 51 54 2 70 69 50 6 6 6 6 6 6 6
6 6 6 6 6 49 2 2 82 32 44 19 45 26 84 2 2 58 64 2 2 2 2 4 4 4 4 2 102 93 93 93 79 2 68 2 50 46 57 2 70 69 56 48 6 6 6 6 6 6
6 6 6 6 6 49 2 2 82 32 18 8 38 19 88 2 2 2 66 62 54 2 2 2 2 4 4 2 2 2 2 2 2 2 2 2 56 57 2 2 70 107 75 50 6 6 6 6 6 6
6 6 6 6 6 51 54 2 82 32 43 19 42 33 84 2 2 2 2 50 49 2 74 72 72 72 72 72 72 72 72 72 72 72 75 2 2 2 2 74 106 1 69 50 6 6 6 6 6 6
6 6 6 6 6 6 51 54 82 17 31 31 31 16 84 2 2 2 2 50 51 54 73 71 71 71 71 71 71 71 71 71 71 71 123 72 72 72 72 106 1 108 76 50 6 6 6 6 6 6
6 6 6 6 6 6 6 49 89 83 83 83 83 83 92 2 2 2 55 53 6 51 52 52 52 52 52 52 52 52 52 52 52 54 73 71 109 1 1 108 71 76 55 53 6 6 6 6 6 6
6 6 6 6 6 6 6 51 52 52 54 2 2 2 2 2 2 55 53 6 6 6 6 6 6 6 6 6 6 6 6 6 6 51 52 54 73 71 71 76 55 52 53 6 6 6 6 6 6 6
6 6 6 6 6 6 6 6 6 6 51 52 52 52 52 52 52 53 6 6 6 6 6 6 6 6 6 6 6 6 6 6 6 6 6 51 52 52 52 52 53 6 6 6 6 6 6 6 6 6
6 6 6 6 6 6 6 6 6 6 6 6 6 6 6 6 6 6 6 6 6 6 6 6 6 6 6 6 6 6 6 6 6 6 6 6 6 6 6 6 6 6 6 6 6 6 6 6 6 6
6 6 6 6 6 6 6 6 6 6 6 6 6 6 6 6 6 6 6 6 6 6 6 6 6 6 6 6 6 6 6 6 6 6 6 6 6 6 6 6 6 6 6 6 6 6 6 6 6 6
6 6 6 6 6 6 6 6 6 6 6 6 6 6 6 6 6 6 6 6 6 6 6 6 6 6 6 6 6 6 6 6 6 6 6 6 6 6 6 6 6 6 6 6 6 6 6 6 6 6
6 6 6 6 6 6 6 6 6 6 6 6 6 6 6 6 6 6 6 6 6 6 6 6 6 6 6 6 6 6 6 6 6 6 6 6 6 6 6 6 6 6 6 6 6 6 6 6 6 6
6 6 6 6 6 6 6 6 6 6 6 6 6 6 6 6 6 6 6 6 6 6 6 6 6 6 6 6 6 6 6 6 6 6 6 6 6 6 6 6 6 6 6 6 6 6 6 6 6 6
