6 6 6 6 6 6 6 6 6 6 6 6 6 6 6 6 6 6 6 6 6 6 6 6 6 6 6 6 6 6 6 6 6 6 6 6 6 6 6 6 6 6 6 6 6 6 6 6 6 6
6 6 6 6 6 6 6 6 6 6 6 6 6 6 6 6 6 6 6 6 6 6 6 6 6 6 6 6 6 6 6 6 6 6 6 6 6 6 6 6 6 6 6 6 6 6 6 6 6 6
6 6 6 6 6 6 6 6 6 6 6 6 6 6 6 6 6 6 6 6 6 6 6 6 6 6 6 6 6 6 6 6 6 6 6 6 6 6 6 6 6 6 6 6 6 6 6 6 6 6
6 6 6 6 6 6 6 6 6 6 6 6 6 6 6 6 6 6 6 6 6 6 6 6 6 6 6 6 6 6 6 6 6 6 6 6 6 6 6 6 6 6 6 6 6 6 6 6 6 6
6 6 6 6 6 6 6 6 6 6 6 6 6 6 6 6 6 6 6 6 6 6 6 6 6 6 6 6 6 6 6 6 6 6 6 6 6 6 6 6 6 6 6 6 6 6 6 6 6 6
6 6 6 6 6 6 6 6 1 1 6 6 6 6 6 6 6 6 6 6 6 6 6 6 6 6 6 6 6 6 6 6 6 6 6 6 1 1 1 1 1 6 6 6 6 6 6 6 6 6
6 6 6 6 6 6 1 1 1 1 1 6 6 6 6 6 6 6 6 6 6 6 6 6 6 6 6 6 6 6 6 6 6 6 6 1 1 1 2 2 2 2 2 6 6 6 6 6 6 6
6 6 6 6 6 1 1 2 2 2 1 1 1 1 1 1 1 1 1 1 1 1 1 1 1 1 1 1 1 1 1 1 1 1 1 1 1 2 2 4 4 4 2 2 6 6 6 6 6 6
6 6 6 6 6 1 2 2 2 2 1 1 1 1 2 2 2 2 2 2 2 2 2 2 2 2 2 2 2 2 2 2 2 2 2 2 2 2 4 4 4 4 4 4 2 6 6 6 6 6
6 6 6 6 6 1 2 2 2 1 1 2 2 2 2 2 2 2 2 2 2 2 2 2 2 2 2 2 2 4 4 4 4 4 4 4 4 4 4 4 4 4 4 2 1 6 6 6 6 6
6 6 6 6 6 1 2 2 1 1 2 2 2 2 2 2 2 4 4 4 4 4 4 4 4 4 4 4 4 4 4 4 4 4 4 4 4 4 4 4 4 2 2 1 1 6 6 6 6 6
6 6 6 6 6 1 2 1 1 2 2 2 4 2 2 2 4 4 4 4 4 4 4 4 4 4 4 4 4 4 2 2 2 4 4 4 4 4 4 2 2 2 1 1 6 6 6 6 6 6
6 6 6 6 6 1 1 1 1 2 2 4 4 4 2 4 4 4 4 4 4 4 4 4 4 4 4 4 4 4 2 4 2 4 2 2 9 4 4 2 1 1 1 6 6 6 6 6 6 6
6 6 6 6 6 6 1 1 1 2 2 4 4 4 2 4 4 4 4 2 2 2 2 2 2 2 2 4 4 2 2 4 2 4 2 4 4 4 4 2 1 1 6 6 6 6 6 6 6 6
6 6 6 6 6 6 6 6 1 2 2 4 4 4 2 4 4 4 4 4 4 4 4 4 4 4 2 4 4 2 4 4 2 4 2 4 4 4 4 2 1 1 6 6 6 6 6 6 6 6
6 6 6 6 6 6 6 6 1 1 2 2 4 2 2 4 4 4 4 4 4 4 4 4 4 4 2 4 4 2 4 2 2 4 2 2 2 2 4 2 2 1 6 6 6 6 6 6 6 6
6 6 6 6 6 6 6 1 1 2 2 2 2 2 4 4 4 4 4 4 4 4 4 4 4 4 2 4 4 2 4 2 4 4 4 4 4 2 4 4 2 1 6 6 6 6 6 6 6 6
6 6 6 6 6 6 1 1 2 2 2 4 4 4 4 4 4 2 2 2 2 2 2 2 2 2 2 2 4 2 4 2 4 2 2 2 4 2 4 4 2 1 6 6 6 6 6 6 6 6
6 6 6 6 6 6 1 2 2 2 4 4 4 4 4 2 2 2 4 4 4 4 4 4 4 2 2 2 2 2 4 2 4 2 4 2 2 2 4 4 2 1 1 6 6 6 6 6 6 6
6 6 6 6 6 49 2 2 2 2 4 2 2 2 4 2 4 4 4 4 4 4 4 4 4 4 4 2 4 4 4 2 2 2 4 4 4 4 4 4 2 1 1 6 6 6 6 6 6 6
6 6 6 6 6 49 2 4 4 2 4 2 4 2 4 2 2 2 4 4 4 4 4 4 4 2 2 2 4 4 4 4 4 4 4 4 4 4 4 4 2 1 1 1 6 6 6 6 6 6
6 6 6 6 6 49 2 4 4 2 2 2 4 2 4 2 2 2 2 2 2 2 2 2 2 2 2 2 2 2 2 2 2 2 2 2 2 2 4 4 2 2 1 1 6 6 6 6 6 6
6 6 6 6 6 49 2 4 4 4 4 4 4 2 2 2 1 1 1 1 1 1 1 1 1 1 1 1 1 1 1 1 1 1 1 1 1 2 4 4 4 2 2 1 6 6 6 6 6 6
6 6 6 6 6 49 2 4 4 4 4 4 4 2 2 2 1 1 1 1 1 1 1 1 1 1 1 1 1 1 1 1 1 1 1 1 1 2 4 4 4 2 2 1 6 6 6 6 6 6
6 6 6 6 6 49 2 4 4 4 4 2 2 2 2 2 2 2 2 2 2 2 2 2 1 1 1 1 2 2 2 2 2 2 2 2 2 2 4 4 4 2 1 1 6 6 6 6 6 6
6 6 6 6 6 49 2 4 4 4 4 2 4 4 4 4 4 4 4 4 4 4 4 2 2 1 1 2 2 4 4 4 4 4 4 4 4 4 4 4 2 2 1 1 6 6 6 6 6 6
6 6 6 6 6 49 2 4 4 4 4 2 4 2 2 2 2 2 2 2 2 4 4 4 2 1 1 2 2 2 2 2 2 2 2 2 2 2 2 4 2 1 1 6 6 6 6 6 6 6
6 6 6 6 6 49 2 4 4 4 4 2 4 2 2 2 2 2 2 2 2 4 4 4 2 1 1 2 4 4 4 4 4 4 4 4 4 4 2 4 2 1 1 6 6 6 6 6 6 6
6 6 6 6 6 49 2 4 4 4 4 2 4 2 2 2 2 2 2 2 2 4 4 4 2 1 1 2 4 4 2 2 2 2 2 2 2 4 2 4 2 1 1 6 6 6 6 6 6 6
6 6 6 6 6 49 2 2 4 4 4 2 2 2 2 2 2 2 2 2 4 4 4 4 2 1 1 2 4 4 2 4 4 4 4 4 2 4 2 4 2 1 1 6 6 6 6 6 6 6
6 6 6 6 6 51 49 2 4 4 4 4 4 4 4 4 4 4 4 2 4 4 4 4 2 1 1 2 4 4 2 4 2 2 2 2 2 4 2 4 2 1 1 6 6 6 6 6 6 6
6 6 6 6 6 6 49 2 4 4 4 4 4 4 4 4 4 4 4 2 2 2 4 4 2 1 1 2 4 4 2 4 4 4 4 4 4 4 2 4 2 1 6 6 6 6 6 6 6 6
6 6 6 6 6 6 49 2 2 2 2 2 4 4 4 4 4 4 4 4 4 2 4 4 2 1 1 2 4 4 2 2 2 2 2 2 2 2 2 4 2 1 6 6 6 6 6 6 6 6
6 6 6 6 6 6 51 52 52 52 49 2 2 2 2 4 4 4 2 2 2 2 4 4 2 1 1 2 4 4 4 4 4 4 4 4 4 4 4 2 2 1 6 6 6 6 6 6 6 6
6 6 6 6 6 6 6 6 1 1 51 52 52 52 2 2 2 2 2 4 4 4 4 4 2 1 1 2 2 2 4 4 4 2 2 2 2 2 2 2 2 1 6 6 6 6 6 6 6 6
6 6 6 6 6 6 6 6 1 1 1 1 1 6 49 2 4 4 4 4 2 4 4 4 2 1 1 1 1 2 4 4 2 2 1 1 1 1 1 2 2 1 6 6 6 6 6 6 6 6
6 6 6 6 6 6 6 6 1 1 1 1 1 1 1 2 2 2 2 2 2 4 4 4 2 2 2 2 1 2 4 4 2 1 1 6 6 6 1 1 2 1 6 6 6 6 6 6 6 6
6 6 6 6 6 6 6 1 1 5 5 5 5 5 1 2 1 1 1 1 2 2 2 4 4 4 2 2 1 2 2 2 2 1 6 6 6 6 6 1 2 1 6 6 6 6 6 6 6 6
6 6 6 6 6 6 1 1 1 5 1 1 1 5 1 2 1 6 6 1 1 1 2 4 4 4 4 2 1 1 1 1 1 1 6 6 6 6 6 1 2 1 6 6 6 6 6 6 6 6
6 6 6 6 6 6 1 1 1 5 1 8 1 1 1 2 1 1 6 6 6 1 2 2 2 4 4 2 2 2 2 2 2 1 1 6 6 6 1 1 2 1 1 6 6 6 6 6 6 6
6 6 6 6 6 6 6 1 1 5 1 1 1 5 1 2 2 1 1 6 6 1 1 1 2 2 2 2 2 2 2 2 2 2 1 1 1 1 1 2 2 2 1 6 6 6 6 6 6 6
6 6 6 6 6 6 6 6 1 5 5 5 5 5 1 2 2 1 1 6 6 6 1 1 1 1 1 1 1 1 1 1 1 1 1 2 2 2 2 2 2 1 1 6 6 6 6 6 6 6
6 6 6 6 6 6 6 6 1 1 1 1 1 1 1 1 1 1 6 6 6 6 6 6 6 6 6 6 6 6 6 6 6 6 1 1 1 2 2 1 1 1 6 6 6 6 6 6 6 6
6 6 6 6 6 6 6 6 6 6 6 1 1 1 1 1 1 6 6 6 6 6 6 6 6 6 6 6 6 6 6 6 6 6 6 6 1 1 1 1 6 6 6 6 6 6 6 6 6 6
6 6 6 6 6 6 6 6 6 6 6 6 6 6 6 6 6 6 6 6 6 6 6 6 6 6 6 6 6 6 6 6 6 6 6 6 6 6 6 6 6 6 6 6 6 6 6 6 6 6
6 6 6 6 6 6 6 6 6 6 6 6 6 6 6 6 6 6 6 6 6 6 6 6 6 6 6 6 6 6 6 6 6 6 6 6 6 6 6 6 6 6 6 6 6 6 6 6 6 6
6 6 6 6 6 6 6 6 6 6 6 6 6 6 6 6 6 6 6 6 6 6 6 6 6 6 6 6 6 6 6 6 6 6 6 6 6 6 6 6 6 6 6 6 6 6 6 6 6 6
6 6 6 6 6 6 6 6 6 6 6 6 6 6 6 6 6 6 6 6 6 6 6 6 6 6 6 6 6 6 6 6 6 6 6 6 6 6 6 6 6 6 6 6 6 6 6 6 6 6
6 6 6 6 6 6 6 6 6 6 6 6 6 6 6 6 6 6 6 6 6 6 6 6 6 6 6 6 6 6 6 6 6 6 6 6 6 6 6 6 6 6 6 6 6 6 6 6 6 6
6 6 6 6 6 6 6 6 6 6 6 6 6 6 6 6 6 6 6 6 6 6 6 6 6 6 6 6 6 6 6 6 6 6 6 6 6 6 6 6 6 6 6 6 6 6 6 6 6 6
